GEOID,NAME,med.income,popn,popn.asian,popn.black,popn.female,popn.hispanic,popn.male,popn.white
36005000100,"Census Tract 1, Bronx County, New York",NA,6864,181,3824,519,2407,6345,2233
36005000200,"Census Tract 2, Bronx County, New York",51100,4532,75,1371,2339,3444,2193,1919
36005000400,"Census Tract 4, Bronx County, New York",78409,5516,208,1677,2706,3661,2810,2436
36005001600,"Census Tract 16, Bronx County, New York",34093,5825,76,2539,3403,3452,2422,1884
36005001900,"Census Tract 19, Bronx County, New York",45156,3141,87,1123,1558,1714,1583,685
36005002000,"Census Tract 20, Bronx County, New York",20592,9040,0,3779,4912,5912,4128,3170
36005002300,"Census Tract 23, Bronx County, New York",18688,4302,0,1616,2342,3062,1960,584
36005002400,"Census Tract 24, Bronx County, New York",NA,155,0,90,33,0,122,65
36005002500,"Census Tract 25, Bronx County, New York",23115,5610,6,1711,2557,3986,3053,1100
36005002701,"Census Tract 27.01, Bronx County, New York",18832,2608,0,862,1444,1965,1164,295
36005002702,"Census Tract 27.02, Bronx County, New York",13097,4560,0,2120,2577,2566,1983,538
36005002800,"Census Tract 28, Bronx County, New York",51138,5151,0,3742,2921,1546,2230,655
36005003100,"Census Tract 31, Bronx County, New York",43255,1689,74,437,865,1190,824,350
36005003300,"Census Tract 33, Bronx County, New York",22127,3277,0,1091,2036,1990,1241,427
36005003500,"Census Tract 35, Bronx County, New York",31310,3907,0,1472,2217,2647,1690,503
36005003700,"Census Tract 37, Bronx County, New York",NA,250,0,102,102,152,148,60
36005003800,"Census Tract 38, Bronx County, New York",33681,1350,0,344,755,1028,595,895
36005003900,"Census Tract 39, Bronx County, New York",25772,6260,0,1128,3073,4767,3187,1308
36005004001,"Census Tract 40.01, Bronx County, New York",54868,1475,161,209,696,991,779,334
36005004100,"Census Tract 41, Bronx County, New York",19643,5942,12,2049,2922,4192,3020,970
36005004200,"Census Tract 42, Bronx County, New York",43293,7697,32,3245,4310,4566,3387,2407
36005004300,"Census Tract 43, Bronx County, New York",21689,5552,52,1904,2969,3956,2583,1065
36005004400,"Census Tract 44, Bronx County, New York",17297,4401,113,1781,2422,2415,1979,625
36005004600,"Census Tract 46, Bronx County, New York",21360,1961,0,716,1069,1189,892,891
36005004800,"Census Tract 48, Bronx County, New York",33403,4563,122,1012,2213,3484,2350,487
36005005001,"Census Tract 50.01, Bronx County, New York",27009,4604,48,1226,2314,3308,2290,292
36005005002,"Census Tract 50.02, Bronx County, New York",31795,5592,54,1195,3019,4418,2573,437
36005005100,"Census Tract 51, Bronx County, New York",19115,5737,34,2016,3255,3959,2482,436
36005005200,"Census Tract 52, Bronx County, New York",21140,1956,8,614,1136,1430,820,259
36005005300,"Census Tract 53, Bronx County, New York",16583,4888,7,2744,2873,2365,2015,541
36005005400,"Census Tract 54, Bronx County, New York",35189,5324,151,1554,2713,3581,2611,517
36005005600,"Census Tract 56, Bronx County, New York",27153,2279,47,632,1227,1542,1052,319
36005005902,"Census Tract 59.02, Bronx County, New York",30844,2751,42,704,1429,1826,1322,483
36005006000,"Census Tract 60, Bronx County, New York",34898,1386,51,351,727,1027,659,364
36005006100,"Census Tract 61, Bronx County, New York",45361,3720,16,2650,2080,1021,1640,349
36005006200,"Census Tract 62, Bronx County, New York",25206,7233,148,2784,3945,4425,3288,716
36005006300,"Census Tract 63, Bronx County, New York",37306,4582,62,1511,2154,2843,2428,1053
36005006400,"Census Tract 64, Bronx County, New York",38415,3932,192,1550,2000,1967,1932,507
36005006500,"Census Tract 65, Bronx County, New York",25467,5377,113,1814,2437,3662,2940,1180
36005006700,"Census Tract 67, Bronx County, New York",19813,6705,0,1928,3255,5018,3450,696
36005006800,"Census Tract 68, Bronx County, New York",54395,3230,416,924,1559,1899,1671,188
36005006900,"Census Tract 69, Bronx County, New York",37590,7801,30,3250,4209,4462,3592,1146
36005007000,"Census Tract 70, Bronx County, New York",50500,4378,602,1015,2206,2423,2172,651
36005007100,"Census Tract 71, Bronx County, New York",42292,2795,75,1125,1494,1750,1301,352
36005007200,"Census Tract 72, Bronx County, New York",43197,6255,2118,919,3017,2681,3238,934
36005007300,"Census Tract 73, Bronx County, New York",22344,4297,0,1207,2357,3050,1940,819
36005007400,"Census Tract 74, Bronx County, New York",39537,3634,0,1213,1853,2423,1781,1435
36005007500,"Census Tract 75, Bronx County, New York",30706,6692,50,2888,3882,4117,2810,1216
36005007600,"Census Tract 76, Bronx County, New York",46176,5311,500,1312,2643,3435,2668,790
36005007700,"Census Tract 77, Bronx County, New York",38417,2022,19,715,1078,1564,944,448
36005007800,"Census Tract 78, Bronx County, New York",52360,7415,839,1888,3834,4585,3581,1612
36005007900,"Census Tract 79, Bronx County, New York",26307,7188,0,2508,3937,5023,3251,729
36005008300,"Census Tract 83, Bronx County, New York",32167,6713,145,1765,3115,5419,3598,847
36005008400,"Census Tract 84, Bronx County, New York",85750,2899,222,852,1423,1784,1476,1025
36005008500,"Census Tract 85, Bronx County, New York",31370,5631,17,1668,3174,3905,2457,720
36005008600,"Census Tract 86, Bronx County, New York",21848,3936,22,2059,2165,1831,1771,1085
36005008700,"Census Tract 87, Bronx County, New York",23967,6127,34,1590,3028,4546,3099,687
36005008900,"Census Tract 89, Bronx County, New York",28642,3218,0,834,1625,2421,1593,465
36005009000,"Census Tract 90, Bronx County, New York",24487,3459,75,944,1883,2498,1576,1539
36005009200,"Census Tract 92, Bronx County, New York",50176,5848,905,1121,3014,3238,2834,1065
36005009300,"Census Tract 93, Bronx County, New York",32852,6154,13,2167,2750,4070,3404,827
36005009600,"Census Tract 96, Bronx County, New York",50809,2792,540,680,1564,1381,1228,660
36005009800,"Census Tract 98, Bronx County, New York",68487,4756,215,1018,2445,3431,2311,2346
36005011000,"Census Tract 110, Bronx County, New York",NA,0,0,0,0,0,0,0
36005011502,"Census Tract 115.02, Bronx County, New York",17656,4582,9,2292,2315,2653,2267,329
36005011700,"Census Tract 117, Bronx County, New York",21595,1443,0,656,902,870,541,24
36005011800,"Census Tract 118, Bronx County, New York",86250,5503,197,501,2486,1965,3017,3802
36005011900,"Census Tract 119, Bronx County, New York",28988,5440,12,1289,2748,3958,2692,734
36005012101,"Census Tract 121.01, Bronx County, New York",39514,3070,14,1181,1654,1951,1416,354
36005012102,"Census Tract 121.02, Bronx County, New York",23244,1447,0,355,725,1248,722,228
36005012300,"Census Tract 123, Bronx County, New York",31519,4268,18,1565,2320,2939,1948,351
36005012500,"Census Tract 125, Bronx County, New York",34903,3860,93,1134,2122,2579,1738,458
36005012701,"Census Tract 127.01, Bronx County, New York",31212,1928,68,473,1061,1410,867,437
36005012901,"Census Tract 129.01, Bronx County, New York",25633,4419,4,1374,2371,3006,2048,592
36005013000,"Census Tract 130, Bronx County, New York",106346,1476,0,135,735,729,741,975
36005013100,"Census Tract 131, Bronx County, New York",26750,5084,0,1986,2613,3489,2471,904
36005013200,"Census Tract 132, Bronx County, New York",118211,7272,141,1667,3371,3805,3901,3771
36005013300,"Census Tract 133, Bronx County, New York",23484,6000,241,2313,3370,3519,2630,999
36005013500,"Census Tract 135, Bronx County, New York",24392,3590,0,1710,1976,2012,1614,340
36005013800,"Census Tract 138, Bronx County, New York",67705,2588,39,202,1500,1132,1088,1703
36005014100,"Census Tract 141, Bronx County, New York",31205,5851,21,2111,3316,3871,2535,547
36005014300,"Census Tract 143, Bronx County, New York",17204,1482,0,1044,838,702,644,47
36005014400,"Census Tract 144, Bronx County, New York",22095,5138,189,2106,2934,3364,2204,1257
36005014500,"Census Tract 145, Bronx County, New York",30676,7436,5,4139,3558,4246,3878,680
36005014701,"Census Tract 147.01, Bronx County, New York",17013,7003,1,4263,3806,2982,3197,594
36005014702,"Census Tract 147.02, Bronx County, New York",22237,5435,0,2607,3031,3146,2404,424
36005014900,"Census Tract 149, Bronx County, New York",29079,4419,0,1888,2282,2494,2137,799
36005015100,"Census Tract 151, Bronx County, New York",29276,5309,0,2594,2720,2771,2589,511
36005015200,"Census Tract 152, Bronx County, New York",73929,2481,99,230,1275,1378,1206,1314
36005015300,"Census Tract 153, Bronx County, New York",24438,4474,47,2630,2270,2229,2204,246
36005015500,"Census Tract 155, Bronx County, New York",22067,2927,34,824,1784,2196,1143,199
36005015700,"Census Tract 157, Bronx County, New York",33468,4704,83,1974,2446,3165,2258,794
36005015800,"Census Tract 158, Bronx County, New York",55700,1314,50,41,671,679,643,672
36005015900,"Census Tract 159, Bronx County, New York",16400,1969,14,197,1034,1790,935,298
36005016000,"Census Tract 160, Bronx County, New York",79756,3666,136,125,1928,1351,1738,2474
36005016100,"Census Tract 161, Bronx County, New York",17960,4650,0,1809,2714,3048,1936,398
36005016200,"Census Tract 162, Bronx County, New York",81210,1870,87,88,981,1104,889,934
36005016300,"Census Tract 163, Bronx County, New York",NA,0,0,0,0,0,0,0
36005016400,"Census Tract 164, Bronx County, New York",80000,1046,0,34,532,311,514,905
36005016500,"Census Tract 165, Bronx County, New York",26739,965,9,543,487,512,478,212
36005016600,"Census Tract 166, Bronx County, New York",78333,2244,106,421,1157,1404,1087,943
36005016700,"Census Tract 167, Bronx County, New York",31600,3695,0,2052,1933,2037,1762,438
36005016900,"Census Tract 169, Bronx County, New York",30221,1633,10,853,881,874,752,216
36005017100,"Census Tract 171, Bronx County, New York",NA,0,0,0,0,0,0,0
36005017300,"Census Tract 173, Bronx County, New York",20662,5746,260,2295,3103,3801,2643,680
36005017500,"Census Tract 175, Bronx County, New York",26630,6536,17,3366,3327,3781,3209,670
36005017701,"Census Tract 177.01, Bronx County, New York",28750,4650,0,2298,2308,2794,2342,569
36005017702,"Census Tract 177.02, Bronx County, New York",34567,5423,62,2265,2706,3120,2717,996
36005017901,"Census Tract 179.01, Bronx County, New York",39036,4831,72,1567,2693,3238,2138,704
36005017902,"Census Tract 179.02, Bronx County, New York",37250,4032,9,1376,2313,2963,1719,570
36005018101,"Census Tract 181.01, Bronx County, New York",NA,3351,0,1541,1944,2174,1407,227
36005018102,"Census Tract 181.02, Bronx County, New York",31602,5294,97,2335,2359,2943,2935,633
36005018301,"Census Tract 183.01, Bronx County, New York",37105,4320,65,1485,2314,2620,2006,730
36005018302,"Census Tract 183.02, Bronx County, New York",41894,3824,23,1163,2087,2632,1737,447
36005018400,"Census Tract 184, Bronx County, New York",79191,3793,229,152,2106,1917,1687,2287
36005018500,"Census Tract 185, Bronx County, New York",25808,9001,0,4771,4378,4854,4623,1112
36005018900,"Census Tract 189, Bronx County, New York",27339,8210,79,2800,4517,5357,3693,1516
36005019300,"Census Tract 193, Bronx County, New York",23927,6350,69,2864,3754,4240,2596,670
36005019400,"Census Tract 194, Bronx County, New York",54167,2375,103,248,1154,1572,1221,938
36005019500,"Census Tract 195, Bronx County, New York",27227,7060,66,2797,3489,4620,3571,1014
36005019700,"Census Tract 197, Bronx County, New York",35100,7561,467,1481,4037,5621,3524,1299
36005019900,"Census Tract 199, Bronx County, New York",42569,8338,0,3066,4400,5599,3938,1431
36005020000,"Census Tract 200, Bronx County, New York",40184,4711,1102,574,2662,2883,2049,745
36005020100,"Census Tract 201, Bronx County, New York",34038,3993,8,1529,2280,2625,1713,547
36005020200,"Census Tract 202, Bronx County, New York",39306,2385,383,446,1257,1461,1128,423
36005020400,"Census Tract 204, Bronx County, New York",51199,3011,543,197,1505,2022,1506,753
36005020501,"Census Tract 205.01, Bronx County, New York",17601,6976,55,2153,3449,4990,3527,827
36005020502,"Census Tract 205.02, Bronx County, New York",18919,2160,3,832,1207,1544,953,168
36005020601,"Census Tract 206.01, Bronx County, New York",48367,2237,724,226,1153,1176,1084,520
36005020900,"Census Tract 209, Bronx County, New York",31190,4287,11,1862,2234,2481,2053,539
36005021001,"Census Tract 210.01, Bronx County, New York",54076,8930,823,4983,4430,3226,4500,1007
36005021002,"Census Tract 210.02, Bronx County, New York",55961,7613,1582,3908,4184,2298,3429,898
36005021100,"Census Tract 211, Bronx County, New York",30092,5343,62,1966,3032,3598,2311,256
36005021200,"Census Tract 212, Bronx County, New York",57500,4850,1136,2156,2698,1561,2152,809
36005021301,"Census Tract 213.01, Bronx County, New York",25509,1267,0,217,773,1053,494,236
36005021302,"Census Tract 213.02, Bronx County, New York",25512,5513,44,2655,3205,3448,2308,521
36005021501,"Census Tract 215.01, Bronx County, New York",33750,4565,0,1422,2617,3515,1948,505
36005021502,"Census Tract 215.02, Bronx County, New York",25238,6532,0,2058,3139,4901,3393,443
36005021601,"Census Tract 216.01, Bronx County, New York",34510,4720,152,1553,2256,2964,2464,967
36005021602,"Census Tract 216.02, Bronx County, New York",55354,5632,1049,2026,3220,2185,2412,1160
36005021700,"Census Tract 217, Bronx County, New York",36420,5124,130,2718,2678,2450,2446,364
36005021800,"Census Tract 218, Bronx County, New York",47581,6520,223,1928,3535,4756,2985,1020
36005021900,"Census Tract 219, Bronx County, New York",26316,882,19,83,410,784,472,65
36005022000,"Census Tract 220, Bronx County, New York",35781,2007,106,519,1073,1421,934,290
36005022101,"Census Tract 221.01, Bronx County, New York",32600,4133,267,1009,2289,2957,1844,396
36005022102,"Census Tract 221.02, Bronx County, New York",32792,5411,33,912,2791,4551,2620,778
36005022200,"Census Tract 222, Bronx County, New York",51064,3293,943,390,1473,1592,1820,550
36005022300,"Census Tract 223, Bronx County, New York",26761,5278,12,932,2973,4197,2305,994
36005022401,"Census Tract 224.01, Bronx County, New York",55909,2498,134,425,1214,1668,1284,420
36005022403,"Census Tract 224.03, Bronx County, New York",51767,3194,26,829,1881,1723,1313,857
36005022404,"Census Tract 224.04, Bronx County, New York",53346,4203,240,931,2206,2371,1997,1189
36005022500,"Census Tract 225, Bronx County, New York",38489,8499,139,2660,4826,6537,3673,1300
36005022701,"Census Tract 227.01, Bronx County, New York",34159,5151,100,2369,3070,2872,2081,497
36005022702,"Census Tract 227.02, Bronx County, New York",26554,1607,114,297,739,1161,868,173
36005022703,"Census Tract 227.03, Bronx County, New York",60938,1688,104,488,855,1144,833,356
36005022800,"Census Tract 228, Bronx County, New York",58431,6128,818,1373,3177,2977,2951,1713
36005022901,"Census Tract 229.01, Bronx County, New York",35461,5743,59,3214,3183,3414,2560,826
36005022902,"Census Tract 229.02, Bronx County, New York",34167,3614,53,984,2039,2777,1575,750
36005023000,"Census Tract 230, Bronx County, New York",38958,2802,257,499,1457,1448,1345,665
36005023100,"Census Tract 231, Bronx County, New York",29263,1537,0,644,773,948,764,333
36005023200,"Census Tract 232, Bronx County, New York",56528,2476,139,388,1289,1238,1187,899
36005023301,"Census Tract 233.01, Bronx County, New York",30861,3956,81,1374,2294,2500,1662,221
36005023302,"Census Tract 233.02, Bronx County, New York",42500,3706,65,1232,1994,3079,1712,887
36005023501,"Census Tract 235.01, Bronx County, New York",34591,3184,22,417,1898,2943,1286,438
36005023502,"Census Tract 235.02, Bronx County, New York",29342,4153,61,1359,2085,3299,2068,1095
36005023600,"Census Tract 236, Bronx County, New York",38021,1816,197,421,1005,740,811,719
36005023702,"Census Tract 237.02, Bronx County, New York",37734,1180,0,229,614,952,566,116
36005023703,"Census Tract 237.03, Bronx County, New York",30109,5574,20,1966,2661,4495,2913,760
36005023704,"Census Tract 237.04, Bronx County, New York",20679,3803,0,808,1998,3071,1805,268
36005023800,"Census Tract 238, Bronx County, New York",52599,2241,174,430,1075,1206,1166,595
36005023900,"Census Tract 239, Bronx County, New York",27615,7873,87,2790,4264,5535,3609,681
36005024000,"Census Tract 240, Bronx County, New York",39688,3903,82,862,1765,2652,2138,858
36005024100,"Census Tract 241, Bronx County, New York",41322,6621,184,2521,3472,4068,3149,725
36005024300,"Census Tract 243, Bronx County, New York",25088,5737,60,1365,3151,4487,2586,647
36005024400,"Census Tract 244, Bronx County, New York",60709,2146,62,90,1101,1197,1045,891
36005024501,"Census Tract 245.01, Bronx County, New York",24146,4871,40,1215,2625,3935,2246,280
36005024502,"Census Tract 245.02, Bronx County, New York",29835,3677,0,1174,2124,2858,1553,522
36005024600,"Census Tract 246, Bronx County, New York",65473,2011,356,116,982,703,1029,1012
36005024700,"Census Tract 247, Bronx County, New York",49107,2058,6,1016,1054,1125,1004,99
36005024800,"Census Tract 248, Bronx County, New York",69786,3078,423,401,1524,903,1554,1795
36005024900,"Census Tract 249, Bronx County, New York",NA,0,0,0,0,0,0,0
36005025000,"Census Tract 250, Bronx County, New York",85868,2591,490,19,1452,797,1139,1730
36005025100,"Census Tract 251, Bronx County, New York",36830,7360,545,1972,3792,5276,3568,555
36005025200,"Census Tract 252, Bronx County, New York",77500,2787,294,157,1413,1208,1374,1486
36005025300,"Census Tract 253, Bronx County, New York",36481,6199,213,1352,3532,4932,2667,535
36005025400,"Census Tract 254, Bronx County, New York",52853,1997,216,110,1058,508,939,1469
36005025500,"Census Tract 255, Bronx County, New York",35466,7674,0,1652,3766,6600,3908,1086
36005025600,"Census Tract 256, Bronx County, New York",52700,1696,165,233,914,1113,782,707
36005025700,"Census Tract 257, Bronx County, New York",52926,1999,4,475,892,1642,1107,195
36005026100,"Census Tract 261, Bronx County, New York",76272,2097,70,1092,1216,908,881,309
36005026300,"Census Tract 263, Bronx County, New York",19629,6218,0,1580,3867,4319,2351,1608
36005026400,"Census Tract 264, Bronx County, New York",48832,4868,513,286,2597,2514,2271,2469
36005026500,"Census Tract 265, Bronx County, New York",41187,7851,288,1170,3720,6492,4131,1548
36005026601,"Census Tract 266.01, Bronx County, New York",60357,3452,100,310,1735,2198,1717,1892
36005026602,"Census Tract 266.02, Bronx County, New York",64143,5084,74,551,2785,2685,2299,3283
36005026701,"Census Tract 267.01, Bronx County, New York",47656,4185,511,854,2195,3072,1990,434
36005026702,"Census Tract 267.02, Bronx County, New York",35557,7895,0,1906,4459,6562,3436,1578
36005026900,"Census Tract 269, Bronx County, New York",39167,3703,50,836,1853,3002,1850,754
36005027300,"Census Tract 273, Bronx County, New York",44154,7778,42,2108,4549,5577,3229,1857
36005027401,"Census Tract 274.01, Bronx County, New York",87500,4693,88,88,2484,1250,2209,3889
36005027402,"Census Tract 274.02, Bronx County, New York",88654,3481,48,111,1849,958,1632,2701
36005027600,"Census Tract 276, Bronx County, New York",NA,24,0,20,19,4,5,4
36005027700,"Census Tract 277, Bronx County, New York",29621,4660,107,780,2403,3270,2257,1340
36005027900,"Census Tract 279, Bronx County, New York",56033,7379,326,984,3610,5023,3769,2516
36005028100,"Census Tract 281, Bronx County, New York",67933,3954,156,904,2138,1760,1816,1957
36005028300,"Census Tract 283, Bronx County, New York",26887,2489,1,986,1466,1437,1023,587
36005028400,"Census Tract 284, Bronx County, New York",NA,554,0,112,293,123,261,356
36005028500,"Census Tract 285, Bronx County, New York",58467,3523,582,230,1816,1162,1707,2184
36005028600,"Census Tract 286, Bronx County, New York",85625,1085,259,45,519,244,566,602
36005028700,"Census Tract 287, Bronx County, New York",56518,3153,229,408,1636,1904,1517,1110
36005028800,"Census Tract 288, Bronx County, New York",74459,3330,567,288,1634,792,1696,1947
36005028900,"Census Tract 289, Bronx County, New York",52754,4807,197,453,2478,3283,2329,2398
36005029301,"Census Tract 293.01, Bronx County, New York",103125,1806,89,151,1006,260,800,1315
36005029302,"Census Tract 293.02, Bronx County, New York",95239,5569,140,546,2712,1478,2857,3985
36005029500,"Census Tract 295, Bronx County, New York",95833,4564,312,608,2503,825,2061,2893
36005029600,"Census Tract 296, Bronx County, New York",54250,1575,355,306,848,628,727,696
36005029700,"Census Tract 297, Bronx County, New York",91210,3799,215,186,2199,858,1600,2870
36005030000,"Census Tract 300, Bronx County, New York",59899,6021,422,728,2707,2979,3314,2837
36005030100,"Census Tract 301, Bronx County, New York",84375,1413,46,133,822,505,591,879
36005030200,"Census Tract 302, Bronx County, New York",54087,8704,51,6409,5071,1899,3633,1032
36005030701,"Census Tract 307.01, Bronx County, New York",121389,5726,204,706,2944,605,2782,4415
36005030900,"Census Tract 309, Bronx County, New York",107768,3709,176,303,2141,773,1568,2950
36005031000,"Census Tract 310, Bronx County, New York",87336,4753,576,1297,2670,1656,2083,1688
36005031200,"Census Tract 312, Bronx County, New York",98250,1678,261,495,833,355,845,740
36005031400,"Census Tract 314, Bronx County, New York",92396,2079,139,465,1060,901,1019,1077
36005031600,"Census Tract 316, Bronx County, New York",86048,1900,313,156,913,551,987,888
36005031800,"Census Tract 318, Bronx County, New York",86429,2179,178,681,1208,791,971,1003
36005031900,"Census Tract 319, Bronx County, New York",NA,633,38,113,424,171,209,393
36005032300,"Census Tract 323, Bronx County, New York",85448,4575,302,523,2315,739,2260,3242
36005032400,"Census Tract 324, Bronx County, New York",19349,3177,207,916,1669,1662,1508,566
36005032600,"Census Tract 326, Bronx County, New York",90656,3407,672,583,1952,861,1455,1544
36005032800,"Census Tract 328, Bronx County, New York",29219,3839,398,441,1950,2478,1889,951
36005033000,"Census Tract 330, Bronx County, New York",39836,5776,0,1044,2906,2113,2870,3128
36005033201,"Census Tract 332.01, Bronx County, New York",47529,5564,78,882,2638,3986,2926,2296
36005033202,"Census Tract 332.02, Bronx County, New York",41969,4033,6,1244,2129,2374,1904,1150
36005033400,"Census Tract 334, Bronx County, New York",NA,15,0,11,9,5,6,2
36005033500,"Census Tract 335, Bronx County, New York",96250,2048,104,134,1100,346,948,1567
36005033600,"Census Tract 336, Bronx County, New York",38387,6714,250,2880,3947,3627,2767,1405
36005033700,"Census Tract 337, Bronx County, New York",97847,2521,185,146,1283,595,1238,1766
36005033800,"Census Tract 338, Bronx County, New York",51204,4105,325,2049,2065,1567,2040,753
36005034000,"Census Tract 340, Bronx County, New York",52772,5606,197,2258,2912,2726,2694,1073
36005034200,"Census Tract 342, Bronx County, New York",60893,1888,79,876,1016,689,872,289
36005034300,"Census Tract 343, Bronx County, New York",78869,1665,71,356,897,674,768,730
36005034400,"Census Tract 344, Bronx County, New York",63017,2172,176,826,1184,1182,988,344
36005034500,"Census Tract 345, Bronx County, New York",74013,3540,155,378,1628,1349,1912,1908
36005034800,"Census Tract 348, Bronx County, New York",42813,5707,124,3271,2970,2342,2737,742
36005035000,"Census Tract 350, Bronx County, New York",74583,2063,131,1291,1134,577,929,214
36005035100,"Census Tract 351, Bronx County, New York",93750,3740,237,281,1934,1196,1806,2741
36005035600,"Census Tract 356, Bronx County, New York",73194,2254,160,1688,1147,320,1107,128
36005035800,"Census Tract 358, Bronx County, New York",69766,8172,132,5828,4329,1967,3843,1046
36005035900,"Census Tract 359, Bronx County, New York",23750,2053,52,564,1027,1582,1026,247
36005036000,"Census Tract 360, Bronx County, New York",83043,3271,340,1549,1645,1038,1626,691
36005036100,"Census Tract 361, Bronx County, New York",21947,5576,3,2109,3412,4082,2164,1266
36005036300,"Census Tract 363, Bronx County, New York",22226,7517,0,2487,3692,5518,3825,1873
36005036400,"Census Tract 364, Bronx County, New York",69750,2565,0,2302,1398,220,1167,52
36005036501,"Census Tract 365.01, Bronx County, New York",27304,3901,0,2047,1961,2120,1940,836
36005036502,"Census Tract 365.02, Bronx County, New York",31588,2620,0,837,1346,1867,1274,271
36005036700,"Census Tract 367, Bronx County, New York",34500,2395,66,829,1211,1581,1184,396
36005036800,"Census Tract 368, Bronx County, New York",50919,2109,18,1570,1154,460,955,153
36005036901,"Census Tract 369.01, Bronx County, New York",22273,2101,0,973,1040,1606,1061,297
36005036902,"Census Tract 369.02, Bronx County, New York",16293,2074,0,992,1113,1272,961,434
36005037000,"Census Tract 370, Bronx County, New York",58636,2416,156,1782,1336,450,1080,150
36005037100,"Census Tract 371, Bronx County, New York",22685,4226,17,1450,2329,3175,1897,1132
36005037200,"Census Tract 372, Bronx County, New York",41346,2132,51,994,1293,926,839,308
36005037300,"Census Tract 373, Bronx County, New York",28900,6373,0,3692,3811,3809,2562,764
36005037400,"Census Tract 374, Bronx County, New York",27695,3861,53,1968,2306,1933,1555,777
36005037504,"Census Tract 375.04, Bronx County, New York",20644,3323,0,1348,1811,2297,1512,866
36005037600,"Census Tract 376, Bronx County, New York",49237,2197,50,879,1070,1092,1127,344
36005037800,"Census Tract 378, Bronx County, New York",41333,2900,19,1931,1438,1015,1462,298
36005037900,"Census Tract 379, Bronx County, New York",24183,5469,115,3316,2809,2760,2660,377
36005038000,"Census Tract 380, Bronx County, New York",37544,5239,67,3891,2793,1641,2446,427
36005038100,"Census Tract 381, Bronx County, New York",38905,7647,20,3499,3791,5852,3856,1949
36005038200,"Census Tract 382, Bronx County, New York",46806,3100,113,1999,1549,1038,1551,316
36005038301,"Census Tract 383.01, Bronx County, New York",43155,5084,76,1326,2589,3848,2495,446
36005038302,"Census Tract 383.02, Bronx County, New York",20519,6032,0,2429,3495,3572,2537,576
36005038500,"Census Tract 385, Bronx County, New York",26509,4766,0,1570,2474,3368,2292,419
36005038600,"Census Tract 386, Bronx County, New York",51798,8889,636,6940,5428,1930,3461,139
36005038700,"Census Tract 387, Bronx County, New York",35970,3823,26,765,1735,2449,2088,745
36005038800,"Census Tract 388, Bronx County, New York",63017,2763,60,2017,1406,648,1357,270
36005038900,"Census Tract 389, Bronx County, New York",37028,5521,220,462,2902,3565,2619,1644
36005039000,"Census Tract 390, Bronx County, New York",45738,2861,96,2182,1417,670,1444,238
36005039100,"Census Tract 391, Bronx County, New York",31985,7544,272,1243,3879,5521,3665,1635
36005039200,"Census Tract 392, Bronx County, New York",50723,1602,0,1265,797,461,805,109
36005039300,"Census Tract 393, Bronx County, New York",19808,8330,83,3269,5088,5206,3242,1249
36005039400,"Census Tract 394, Bronx County, New York",48023,5647,0,3611,3094,1967,2553,724
36005039500,"Census Tract 395, Bronx County, New York",29000,4257,31,2220,2281,2480,1976,613
36005039600,"Census Tract 396, Bronx County, New York",44458,5022,12,3853,2772,1093,2250,434
36005039700,"Census Tract 397, Bronx County, New York",33854,3744,206,239,2114,1059,1630,2495
36005039800,"Census Tract 398, Bronx County, New York",80024,3842,31,3305,2254,522,1588,272
36005039901,"Census Tract 399.01, Bronx County, New York",28049,5618,239,1165,2760,4163,2858,729
36005039902,"Census Tract 399.02, Bronx County, New York",36683,5646,60,827,2859,4562,2787,531
36005040100,"Census Tract 401, Bronx County, New York",37012,4478,27,908,2297,3891,2181,433
36005040302,"Census Tract 403.02, Bronx County, New York",37759,4192,170,638,2238,3409,1954,425
36005040303,"Census Tract 403.03, Bronx County, New York",37043,4900,149,985,2446,3612,2454,835
36005040304,"Census Tract 403.04, Bronx County, New York",25897,3593,155,422,1999,3279,1594,464
36005040400,"Census Tract 404, Bronx County, New York",79442,3600,0,3004,2040,545,1560,337
36005040501,"Census Tract 405.01, Bronx County, New York",37935,4399,128,756,2082,3727,2317,308
36005040502,"Census Tract 405.02, Bronx County, New York",29670,7264,436,2282,3754,4646,3510,792
36005040600,"Census Tract 406, Bronx County, New York",49671,3547,54,2872,2020,668,1527,323
36005040701,"Census Tract 407.01, Bronx County, New York",34695,3120,52,346,1650,2682,1470,809
36005040702,"Census Tract 407.02, Bronx County, New York",37275,7023,407,884,3677,5527,3346,1413
36005040800,"Census Tract 408, Bronx County, New York",31110,4826,27,3140,2747,1387,2079,723
36005040900,"Census Tract 409, Bronx County, New York",52956,3194,84,1945,1666,489,1528,665
36005041100,"Census Tract 411, Bronx County, New York",41587,3510,172,898,1839,2230,1671,783
36005041300,"Census Tract 413, Bronx County, New York",53032,8677,220,1232,4411,6605,4266,1557
36005041400,"Census Tract 414, Bronx County, New York",49545,5158,147,3541,2855,1233,2303,522
36005041500,"Census Tract 415, Bronx County, New York",43538,6367,220,1008,3208,4673,3159,899
36005041800,"Census Tract 418, Bronx County, New York",39712,3876,517,1959,2238,1432,1638,841
36005041900,"Census Tract 419, Bronx County, New York",35837,6035,716,1024,3068,3936,2967,1926
36005042000,"Census Tract 420, Bronx County, New York",42689,4206,232,2650,2412,1316,1794,627
36005042100,"Census Tract 421, Bronx County, New York",38083,5661,625,1166,3129,3354,2532,1413
36005042200,"Census Tract 422, Bronx County, New York",60500,3285,49,2446,1822,592,1463,184
36005042300,"Census Tract 423, Bronx County, New York",38802,4313,443,629,2406,2827,1907,1509
36005042400,"Census Tract 424, Bronx County, New York",86422,2569,43,2015,1456,378,1113,241
36005042500,"Census Tract 425, Bronx County, New York",31723,6175,680,659,2895,4126,3280,1987
36005042600,"Census Tract 426, Bronx County, New York",85023,6729,314,5758,3478,392,3251,495
36005042800,"Census Tract 428, Bronx County, New York",82599,2120,11,1747,1284,287,836,257
36005042901,"Census Tract 429.01, Bronx County, New York",40024,3561,645,408,1887,2393,1674,1181
36005042902,"Census Tract 429.02, Bronx County, New York",35956,4041,86,1486,2112,2573,1929,482
36005043000,"Census Tract 430, Bronx County, New York",63324,3499,277,2171,1954,449,1545,367
36005043100,"Census Tract 431, Bronx County, New York",35995,10246,1074,2686,5434,6170,4812,2341
36005043400,"Census Tract 434, Bronx County, New York",62000,3710,242,2253,1929,1091,1781,550
36005043500,"Census Tract 435, Bronx County, New York",27813,499,0,212,334,179,165,81
36005043600,"Census Tract 436, Bronx County, New York",66250,2020,89,1370,1007,372,1013,164
36005044200,"Census Tract 442, Bronx County, New York",55000,4019,0,3046,2324,1053,1695,632
36005044400,"Census Tract 444, Bronx County, New York",77740,4295,165,3471,2131,499,2164,404
36005044800,"Census Tract 448, Bronx County, New York",96875,2075,0,1765,1132,120,943,128
36005044901,"Census Tract 449.01, Bronx County, New York",69200,1763,32,156,912,206,851,1466
36005044902,"Census Tract 449.02, Bronx County, New York",80833,2041,101,171,916,296,1125,1629
36005045101,"Census Tract 451.01, Bronx County, New York",81094,1455,118,60,742,111,713,1179
36005045102,"Census Tract 451.02, Bronx County, New York",75089,1955,23,123,1110,320,845,1649
36005045600,"Census Tract 456, Bronx County, New York",93472,3220,57,1964,1700,899,1520,955
36005045800,"Census Tract 458, Bronx County, New York",24341,5744,54,2569,3517,3440,2227,1132
36005046000,"Census Tract 460, Bronx County, New York",31932,3246,26,2645,1875,971,1371,262
36005046201,"Census Tract 462.01, Bronx County, New York",52601,28109,876,17568,15931,8110,12178,4759
36005046202,"Census Tract 462.02, Bronx County, New York",62532,9912,125,7157,5556,3162,4356,861
36005048400,"Census Tract 484, Bronx County, New York",74958,4277,0,3365,2224,774,2053,250
36005050400,"Census Tract 504, Bronx County, New York",NA,0,0,0,0,0,0,0
36005051600,"Census Tract 516, Bronx County, New York",96366,4531,227,1,2260,1904,2271,3084
36047000100,"Census Tract 1, Kings County, New York",96250,4405,383,645,2318,223,2087,3011
36047000200,"Census Tract 2, Kings County, New York",56080,1167,58,37,469,908,698,650
36047000301,"Census Tract 3.01, Kings County, New York",137157,3924,219,115,2003,72,1921,3319
36047000501,"Census Tract 5.01, Kings County, New York",133750,4308,469,226,2461,485,1847,3314
36047000502,"Census Tract 5.02, Kings County, New York",146574,2697,308,85,1487,126,1210,2229
36047000700,"Census Tract 7, Kings County, New York",160272,3906,180,138,2038,244,1868,3312
36047000900,"Census Tract 9, Kings County, New York",169255,4518,498,197,2247,367,2271,3524
36047001100,"Census Tract 11, Kings County, New York",142813,1468,244,141,610,163,858,972
36047001300,"Census Tract 13, Kings County, New York",109208,1917,192,198,923,320,994,1311
36047001500,"Census Tract 15, Kings County, New York",87237,9011,2159,2401,5110,1612,3901,3011
36047001800,"Census Tract 18, Kings County, New York",NA,1897,57,840,0,712,1897,709
36047002000,"Census Tract 20, Kings County, New York",45511,1412,99,36,708,1276,704,671
36047002100,"Census Tract 21, Kings County, New York",228276,5106,536,207,2576,326,2530,4052
36047002200,"Census Tract 22, Kings County, New York",41811,4698,502,295,2500,3060,2198,2501
36047002300,"Census Tract 23, Kings County, New York",18387,4219,533,1876,2395,1644,1824,373
36047002901,"Census Tract 29.01, Kings County, New York",29651,4447,789,2494,2458,840,1989,375
36047003000,"Census Tract 30, Kings County, New York",88750,1718,229,155,876,279,842,1145
36047003100,"Census Tract 31, Kings County, New York",116250,3259,694,814,1774,320,1485,1541
36047003300,"Census Tract 33, Kings County, New York",136250,4202,480,1235,2161,349,2041,1996
36047003400,"Census Tract 34, Kings County, New York",78833,3161,796,205,1607,513,1554,1942
36047003500,"Census Tract 35, Kings County, New York",112917,1907,196,540,976,183,931,960
36047003600,"Census Tract 36, Kings County, New York",69632,3500,640,70,2076,658,1424,2512
36047003700,"Census Tract 37, Kings County, New York",155682,2250,361,221,1067,149,1183,1532
36047003800,"Census Tract 38, Kings County, New York",81576,1371,278,0,684,65,687,966
36047003900,"Census Tract 39, Kings County, New York",105000,2262,384,194,1227,309,1035,1506
36047004100,"Census Tract 41, Kings County, New York",166339,3654,267,366,1706,335,1948,2807
36047004300,"Census Tract 43, Kings County, New York",137095,3727,406,376,1646,526,2081,2532
36047004400,"Census Tract 44, Kings County, New York",118594,2518,253,10,1225,213,1293,2179
36047004500,"Census Tract 45, Kings County, New York",148064,3385,340,137,1780,125,1605,2752
36047004600,"Census Tract 46, Kings County, New York",131806,1301,115,0,703,189,598,1160
36047004700,"Census Tract 47, Kings County, New York",119500,1877,104,292,1034,282,843,1294
36047004900,"Census Tract 49, Kings County, New York",134706,2612,211,402,1289,332,1323,1718
36047005000,"Census Tract 50, Kings County, New York",131042,2260,218,35,1211,244,1049,1943
36047005100,"Census Tract 51, Kings County, New York",147188,2744,162,93,1432,221,1312,2100
36047005201,"Census Tract 52.01, Kings County, New York",NA,1707,335,18,1025,207,682,1219
36047005202,"Census Tract 52.02, Kings County, New York",77240,2442,52,44,1241,212,1201,2236
36047005300,"Census Tract 53, Kings County, New York",104583,2167,68,275,1043,527,1124,1528
36047005400,"Census Tract 54, Kings County, New York",77569,3185,543,68,1629,292,1556,2345
36047005601,"Census Tract 56.01, Kings County, New York",85923,2447,161,165,1340,351,1107,2008
36047005602,"Census Tract 56.02, Kings County, New York",74167,1687,198,33,897,368,790,1166
36047005800,"Census Tract 58, Kings County, New York",64875,2827,331,26,1443,527,1384,2067
36047005900,"Census Tract 59, Kings County, New York",71042,1213,35,120,589,310,624,846
36047006000,"Census Tract 60, Kings County, New York",100324,3148,472,0,1550,1016,1598,2167
36047006200,"Census Tract 62, Kings County, New York",83387,2676,472,69,1320,453,1356,1898
36047006300,"Census Tract 63, Kings County, New York",124853,1866,129,27,994,120,872,1583
36047006400,"Census Tract 64, Kings County, New York",76694,3042,243,29,1502,427,1540,2466
36047006500,"Census Tract 65, Kings County, New York",165859,5976,277,104,3048,409,2928,5246
36047006600,"Census Tract 66, Kings County, New York",70250,3542,439,39,1778,679,1764,2698
36047006700,"Census Tract 67, Kings County, New York",171477,3886,121,83,1983,352,1903,3429
36047006800,"Census Tract 68, Kings County, New York",56768,4900,1026,59,2374,1681,2526,2853
36047006900,"Census Tract 69, Kings County, New York",154625,3591,188,147,1979,252,1612,3072
36047007000,"Census Tract 70, Kings County, New York",78906,2538,536,144,1293,325,1245,1438
36047007100,"Census Tract 71, Kings County, New York",40938,5050,226,1823,2894,2131,2156,1515
36047007200,"Census Tract 72, Kings County, New York",40574,1900,378,70,1011,1323,889,734
36047007400,"Census Tract 74, Kings County, New York",33934,5259,1418,30,2646,3127,2613,2103
36047007500,"Census Tract 75, Kings County, New York",138188,4969,310,119,2694,860,2275,3828
36047007600,"Census Tract 76, Kings County, New York",42950,5151,719,229,2703,3481,2448,2230
36047007700,"Census Tract 77, Kings County, New York",151307,5159,561,170,2708,629,2451,3891
36047007800,"Census Tract 78, Kings County, New York",43792,5246,709,127,2561,4016,2685,2514
36047008000,"Census Tract 80, Kings County, New York",64225,3615,346,58,1647,2502,1968,2254
36047008200,"Census Tract 82, Kings County, New York",41831,3594,473,233,1808,2288,1786,1360
36047008400,"Census Tract 84, Kings County, New York",53304,3621,258,136,1697,2575,1924,1807
36047008500,"Census Tract 85, Kings County, New York",15283,7793,430,4653,4929,2702,2864,1093
36047008600,"Census Tract 86, Kings County, New York",NA,0,0,0,0,0,0,0
36047008800,"Census Tract 88, Kings County, New York",64091,2235,465,149,1100,670,1135,1250
36047009000,"Census Tract 90, Kings County, New York",47197,3000,1027,112,1550,1601,1450,979
36047009200,"Census Tract 92, Kings County, New York",46622,5322,2389,230,2807,2095,2515,1458
36047009400,"Census Tract 94, Kings County, New York",51042,5066,3448,75,2701,888,2365,864
36047009600,"Census Tract 96, Kings County, New York",44671,6079,1589,324,3134,3260,2945,2337
36047009800,"Census Tract 98, Kings County, New York",46250,6479,2663,282,3107,3273,3372,1034
36047010000,"Census Tract 100, Kings County, New York",56512,6035,3178,96,2927,2207,3108,1586
36047010100,"Census Tract 101, Kings County, New York",75707,4001,488,191,2010,2185,1991,1749
36047010200,"Census Tract 102, Kings County, New York",56082,4698,3363,20,2276,1187,2422,619
36047010400,"Census Tract 104, Kings County, New York",44288,4805,4009,80,2398,297,2407,462
36047010600,"Census Tract 106, Kings County, New York",49702,4417,3373,129,2287,632,2130,379
36047010800,"Census Tract 108, Kings County, New York",45082,3866,2658,93,1981,856,1885,354
36047011000,"Census Tract 110, Kings County, New York",61042,2662,692,14,1304,885,1358,1466
36047011200,"Census Tract 112, Kings County, New York",33673,6188,1529,220,3098,1827,3090,3750
36047011400,"Census Tract 114, Kings County, New York",47306,3796,1139,299,2079,438,1717,2277
36047011600,"Census Tract 116, Kings County, New York",40640,3594,2790,13,1753,346,1841,560
36047011700,"Census Tract 117, Kings County, New York",101628,2677,298,231,1310,563,1367,1559
36047011800,"Census Tract 118, Kings County, New York",54236,2105,1781,0,1062,212,1043,119
36047011900,"Census Tract 119, Kings County, New York",93854,1322,56,99,647,279,675,949
36047012000,"Census Tract 120, Kings County, New York",50833,1213,958,0,625,219,588,85
36047012100,"Census Tract 121, Kings County, New York",98906,1962,187,142,990,595,972,1363
36047012200,"Census Tract 122, Kings County, New York",50384,5482,2585,0,2412,2451,3070,948
36047012600,"Census Tract 126, Kings County, New York",53621,2838,1000,124,1439,792,1399,902
36047012700,"Census Tract 127, Kings County, New York",55145,4318,230,1810,2188,822,2130,1852
36047012801,"Census Tract 128.01, Kings County, New York",38580,2293,1481,41,1085,95,1208,724
36047012901,"Census Tract 129.01, Kings County, New York",119875,2387,155,233,1211,448,1176,1644
36047012902,"Census Tract 129.02, Kings County, New York",127159,2554,162,432,1306,409,1248,1716
36047013000,"Census Tract 130, Kings County, New York",77166,4615,840,263,2196,1119,2419,2481
36047013100,"Census Tract 131, Kings County, New York",147969,4155,416,351,2440,705,1715,2696
36047013200,"Census Tract 132, Kings County, New York",55865,2372,1208,81,1281,432,1091,841
36047013300,"Census Tract 133, Kings County, New York",192813,4454,447,236,2374,426,2080,3342
36047013400,"Census Tract 134, Kings County, New York",81774,4117,863,87,2263,625,1854,2830
36047013500,"Census Tract 135, Kings County, New York",156027,4014,461,82,2211,215,1803,3094
36047013600,"Census Tract 136, Kings County, New York",86165,3609,289,51,1813,533,1796,2925
36047013700,"Census Tract 137, Kings County, New York",116438,3554,322,408,1844,559,1710,2469
36047013800,"Census Tract 138, Kings County, New York",60950,3169,422,139,1677,619,1492,2469
36047013900,"Census Tract 139, Kings County, New York",143169,3650,189,460,1872,473,1778,2601
36047014000,"Census Tract 140, Kings County, New York",69750,1986,345,140,989,270,997,1322
36047014100,"Census Tract 141, Kings County, New York",101250,2766,294,146,1369,564,1397,1987
36047014200,"Census Tract 142, Kings County, New York",58558,3051,432,48,1674,541,1377,2051
36047014300,"Census Tract 143, Kings County, New York",110329,3672,235,233,2019,1271,1653,2467
36047014500,"Census Tract 145, Kings County, New York",87543,3815,220,49,1865,1299,1950,2809
36047014700,"Census Tract 147, Kings County, New York",97589,2408,120,77,1224,922,1184,1862
36047014800,"Census Tract 148, Kings County, New York",83068,1213,152,0,632,203,581,1002
36047014900,"Census Tract 149, Kings County, New York",140481,5859,540,50,2853,1213,3006,4929
36047015000,"Census Tract 150, Kings County, New York",76083,1598,390,5,855,129,743,1138
36047015100,"Census Tract 151, Kings County, New York",146458,4240,401,83,2412,548,1828,3379
36047015200,"Census Tract 152, Kings County, New York",92650,2499,615,106,1244,336,1255,1599
36047015300,"Census Tract 153, Kings County, New York",138594,2622,197,101,1275,385,1347,2169
36047015400,"Census Tract 154, Kings County, New York",NA,11,0,11,11,0,0,0
36047015500,"Census Tract 155, Kings County, New York",163967,3993,99,321,2050,396,1943,3277
36047015700,"Census Tract 157, Kings County, New York",123008,4111,420,225,1965,304,2146,3135
36047015900,"Census Tract 159, Kings County, New York",149900,4804,436,235,2404,224,2400,3796
36047016000,"Census Tract 160, Kings County, New York",82837,3965,835,178,2139,761,1826,2406
36047016100,"Census Tract 161, Kings County, New York",150469,3595,250,394,1829,717,1766,2275
36047016200,"Census Tract 162, Kings County, New York",80590,2294,60,138,1318,628,976,1688
36047016300,"Census Tract 163, Kings County, New York",101688,3388,148,497,1735,216,1653,2504
36047016400,"Census Tract 164, Kings County, New York",106570,1264,52,459,507,153,757,624
36047016500,"Census Tract 165, Kings County, New York",173939,5919,453,195,3249,340,2670,4855
36047016600,"Census Tract 166, Kings County, New York",113527,1791,206,0,933,109,858,1561
36047016700,"Census Tract 167, Kings County, New York",173113,5422,328,131,2938,487,2484,4789
36047016800,"Census Tract 168, Kings County, New York",88750,1905,725,0,1035,148,870,1110
36047016900,"Census Tract 169, Kings County, New York",117256,4822,433,38,2764,591,2058,3857
36047017000,"Census Tract 170, Kings County, New York",76857,3484,1508,40,1802,595,1682,1723
36047017100,"Census Tract 171, Kings County, New York",134821,4069,334,35,2087,474,1982,3426
36047017200,"Census Tract 172, Kings County, New York",82869,3262,1581,3,1558,628,1704,1310
36047017400,"Census Tract 174, Kings County, New York",99750,2191,767,0,1077,270,1114,1140
36047017500,"Census Tract 175, Kings County, New York",NA,0,0,0,0,0,0,0
36047017600,"Census Tract 176, Kings County, New York",63981,2413,634,23,1220,380,1193,1550
36047017700,"Census Tract 177, Kings County, New York",NA,0,0,0,0,0,0,0
36047017800,"Census Tract 178, Kings County, New York",70491,3073,1168,76,1451,1061,1622,1388
36047017900,"Census Tract 179, Kings County, New York",61311,4348,336,2276,2532,555,1816,1100
36047018000,"Census Tract 180, Kings County, New York",68690,3518,1433,36,1705,929,1813,1684
36047018100,"Census Tract 181, Kings County, New York",96452,3691,230,1041,1885,224,1806,2179
36047018200,"Census Tract 182, Kings County, New York",53625,3501,1767,60,1909,505,1592,1212
36047018300,"Census Tract 183, Kings County, New York",126507,2675,124,477,1327,121,1348,1856
36047018400,"Census Tract 184, Kings County, New York",63333,2617,1294,0,1385,169,1232,1212
36047018501,"Census Tract 185.01, Kings County, New York",26130,4153,206,2574,2287,1351,1866,806
36047018600,"Census Tract 186, Kings County, New York",55000,2155,855,0,1106,148,1049,1161
36047018700,"Census Tract 187, Kings County, New York",108661,1488,172,223,705,329,783,773
36047018800,"Census Tract 188, Kings County, New York",76422,2836,1097,9,1479,196,1357,1539
36047019000,"Census Tract 190, Kings County, New York",50875,4763,2001,69,2252,1324,2511,1934
36047019100,"Census Tract 191, Kings County, New York",89176,2972,301,613,1658,425,1314,1840
36047019200,"Census Tract 192, Kings County, New York",42828,2934,1301,23,1344,537,1590,1215
36047019300,"Census Tract 193, Kings County, New York",55389,5882,683,2350,3572,879,2310,2463
36047019400,"Census Tract 194, Kings County, New York",44258,4027,1963,7,2058,1225,1969,1418
36047019500,"Census Tract 195, Kings County, New York",99853,3441,130,1030,1802,319,1639,2078
36047019600,"Census Tract 196, Kings County, New York",47389,4214,1661,50,2097,1012,2117,1693
36047019700,"Census Tract 197, Kings County, New York",118958,3714,243,1151,1830,234,1884,2132
36047019800,"Census Tract 198, Kings County, New York",67813,1926,801,0,978,318,948,848
36047019900,"Census Tract 199, Kings County, New York",108333,3432,144,909,1857,484,1575,2063
36047020000,"Census Tract 200, Kings County, New York",75438,2417,911,14,1201,484,1216,1233
36047020100,"Census Tract 201, Kings County, New York",118285,3945,195,1043,2050,174,1895,2343
36047020200,"Census Tract 202, Kings County, New York",89000,1963,590,32,1006,177,957,1292
36047020300,"Census Tract 203, Kings County, New York",123229,1826,183,561,1026,391,800,798
36047020400,"Census Tract 204, Kings County, New York",102000,1837,487,0,1010,49,827,1295
36047020500,"Census Tract 205, Kings County, New York",123274,3128,491,494,1735,89,1393,1758
36047020600,"Census Tract 206, Kings County, New York",101449,2311,626,11,1108,301,1203,1583
36047020700,"Census Tract 207, Kings County, New York",119462,4726,190,1134,2334,748,2392,3016
36047020800,"Census Tract 208, Kings County, New York",62432,3092,1743,79,1595,140,1497,963
36047021000,"Census Tract 210, Kings County, New York",56875,3967,2210,48,2112,484,1855,1306
36047021100,"Census Tract 211, Kings County, New York",49679,2206,88,999,1303,769,903,634
36047021200,"Census Tract 212, Kings County, New York",44967,4334,2713,0,2271,647,2063,1035
36047021300,"Census Tract 213, Kings County, New York",52885,4113,36,2961,2174,301,1939,801
36047021400,"Census Tract 214, Kings County, New York",57875,2187,762,0,1072,272,1115,1223
36047021500,"Census Tract 215, Kings County, New York",86534,5638,375,2078,3253,358,2385,2480
36047021600,"Census Tract 216, Kings County, New York",48716,4022,309,0,1886,462,2136,3362
36047021700,"Census Tract 217, Kings County, New York",61466,3733,271,1816,2227,679,1506,882
36047021800,"Census Tract 218, Kings County, New York",31047,3128,144,13,1678,229,1450,2787
36047021900,"Census Tract 219, Kings County, New York",72440,3557,265,1998,1974,284,1583,1124
36047022000,"Census Tract 220, Kings County, New York",32088,4776,296,256,2123,155,2653,3971
36047022100,"Census Tract 221, Kings County, New York",54898,3976,195,1830,1978,472,1998,1628
36047022200,"Census Tract 222, Kings County, New York",33088,4008,121,0,2042,142,1966,3818
36047022400,"Census Tract 224, Kings County, New York",47995,5785,973,7,2802,630,2983,4634
36047022600,"Census Tract 226, Kings County, New York",46611,2233,258,58,977,935,1256,1262
36047022700,"Census Tract 227, Kings County, New York",95882,3794,179,1667,1814,266,1980,1563
36047022800,"Census Tract 228, Kings County, New York",35985,3627,759,108,1903,294,1724,2493
36047022900,"Census Tract 229, Kings County, New York",83043,3675,303,1579,2066,283,1609,1637
36047023000,"Census Tract 230, Kings County, New York",43459,4251,150,89,2130,432,2121,3862
36047023100,"Census Tract 231, Kings County, New York",91047,3696,145,1475,2076,518,1620,1707
36047023200,"Census Tract 232, Kings County, New York",38818,5561,297,33,2633,732,2928,5075
36047023300,"Census Tract 233, Kings County, New York",57721,5884,354,2779,3386,1088,2498,2094
36047023400,"Census Tract 234, Kings County, New York",32237,4563,10,13,2509,192,2054,4381
36047023500,"Census Tract 235, Kings County, New York",61607,4694,140,694,2569,969,2125,3204
36047023600,"Census Tract 236, Kings County, New York",26855,5549,207,0,2802,66,2747,5170
36047023800,"Census Tract 238, Kings County, New York",33780,3634,0,0,1866,85,1768,3548
36047024000,"Census Tract 240, Kings County, New York",39034,4823,6,41,2551,494,2272,4381
36047024100,"Census Tract 241, Kings County, New York",61192,2765,68,394,1488,679,1277,1888
36047024200,"Census Tract 242, Kings County, New York",63698,2868,194,0,1320,126,1548,2648
36047024300,"Census Tract 243, Kings County, New York",59779,4122,128,2103,2238,466,1884,1543
36047024400,"Census Tract 244, Kings County, New York",68516,3609,405,7,1614,295,1995,2948
36047024500,"Census Tract 245, Kings County, New York",85169,4491,403,2552,2365,322,2126,1388
36047024600,"Census Tract 246, Kings County, New York",51354,2880,897,21,1367,400,1513,1663
36047024700,"Census Tract 247, Kings County, New York",46518,2672,180,1624,1339,214,1333,609
36047024800,"Census Tract 248, Kings County, New York",49940,2653,1137,5,1304,484,1349,1192
36047024900,"Census Tract 249, Kings County, New York",70268,4018,111,2126,2228,341,1790,1419
36047025000,"Census Tract 250, Kings County, New York",53186,1853,1222,0,843,392,1010,263
36047025100,"Census Tract 251, Kings County, New York",39474,3741,91,2088,2215,562,1526,978
36047025200,"Census Tract 252, Kings County, New York",60173,5299,2104,194,2535,1080,2764,2037
36047025300,"Census Tract 253, Kings County, New York",55417,3496,156,1767,1713,499,1783,1421
36047025400,"Census Tract 254, Kings County, New York",44886,3413,1795,0,1855,198,1558,1439
36047025500,"Census Tract 255, Kings County, New York",21865,5598,122,2502,3412,3649,2186,893
36047025600,"Census Tract 256, Kings County, New York",51625,3199,2087,54,1820,184,1379,771
36047025700,"Census Tract 257, Kings County, New York",69074,2476,33,674,1128,1088,1348,1014
36047025800,"Census Tract 258, Kings County, New York",50625,4354,1723,1,2206,816,2148,2138
36047025901,"Census Tract 259.01, Kings County, New York",59762,2257,37,918,1057,723,1200,807
36047025902,"Census Tract 259.02, Kings County, New York",18167,3533,102,2024,2222,1751,1311,359
36047026000,"Census Tract 260, Kings County, New York",48214,3214,1781,0,1678,205,1536,1178
36047026100,"Census Tract 261, Kings County, New York",51885,4497,113,2171,2640,1383,1857,1267
36047026200,"Census Tract 262, Kings County, New York",65577,2425,1230,54,1161,342,1264,849
36047026300,"Census Tract 263, Kings County, New York",41875,2015,63,1288,1005,218,1010,526
36047026400,"Census Tract 264, Kings County, New York",48942,4594,2178,110,2165,999,2429,1591
36047026500,"Census Tract 265, Kings County, New York",70707,4118,92,2204,2039,869,2079,1189
36047026600,"Census Tract 266, Kings County, New York",51250,3517,2342,0,1764,416,1753,743
36047026700,"Census Tract 267, Kings County, New York",64401,4055,102,2318,2058,528,1997,1276
36047026800,"Census Tract 268, Kings County, New York",44517,3965,1483,3,2074,862,1891,1976
36047026900,"Census Tract 269, Kings County, New York",66534,3147,242,2334,1742,285,1405,556
36047027000,"Census Tract 270, Kings County, New York",50775,2139,633,0,1052,197,1087,1327
36047027100,"Census Tract 271, Kings County, New York",56136,3103,233,2281,1545,396,1558,481
36047027200,"Census Tract 272, Kings County, New York",58477,3755,1247,0,1849,1226,1906,1876
36047027300,"Census Tract 273, Kings County, New York",56786,3431,75,2627,1866,130,1565,528
36047027400,"Census Tract 274, Kings County, New York",70625,3602,1419,30,1935,625,1667,1687
36047027500,"Census Tract 275, Kings County, New York",82069,4438,277,2986,2388,312,2050,880
36047027600,"Census Tract 276, Kings County, New York",53283,3646,1326,10,1738,1257,1908,1456
36047027700,"Census Tract 277, Kings County, New York",50290,4582,44,3335,2652,555,1930,594
36047027800,"Census Tract 278, Kings County, New York",57202,3118,1505,70,1630,359,1488,1306
36047027900,"Census Tract 279, Kings County, New York",64700,3660,43,2728,1846,335,1814,611
36047028000,"Census Tract 280, Kings County, New York",75677,1829,771,122,824,300,1005,811
36047028100,"Census Tract 281, Kings County, New York",31682,4764,147,2580,2814,1321,1950,1065
36047028200,"Census Tract 282, Kings County, New York",67212,3762,1972,178,1953,365,1809,1335
36047028300,"Census Tract 283, Kings County, New York",29306,3863,73,1834,1920,1415,1943,1151
36047028400,"Census Tract 284, Kings County, New York",61331,3532,1271,31,1662,685,1870,1814
36047028501,"Census Tract 285.01, Kings County, New York",87778,454,51,23,169,278,285,181
36047028502,"Census Tract 285.02, Kings County, New York",23899,3205,154,2048,1901,1349,1304,92
36047028600,"Census Tract 286, Kings County, New York",40325,5110,1218,84,2606,892,2504,2572
36047028700,"Census Tract 287, Kings County, New York",40969,3093,368,1684,1660,730,1433,812
36047028800,"Census Tract 288, Kings County, New York",55625,3836,1288,19,1767,1102,2069,1581
36047028900,"Census Tract 289, Kings County, New York",44313,3619,113,2096,1726,970,1893,752
36047029000,"Census Tract 290, Kings County, New York",44318,3580,917,0,1829,289,1751,2268
36047029100,"Census Tract 291, Kings County, New York",80526,2991,11,2012,1630,440,1361,746
36047029200,"Census Tract 292, Kings County, New York",49145,3033,959,92,1487,655,1546,1478
36047029300,"Census Tract 293, Kings County, New York",42238,3437,186,2112,1904,744,1533,688
36047029400,"Census Tract 294, Kings County, New York",57895,2474,701,206,1271,296,1203,1444
36047029500,"Census Tract 295, Kings County, New York",60881,4160,202,2660,2282,315,1878,965
36047029600,"Census Tract 296, Kings County, New York",56250,5849,1955,69,3034,924,2815,3196
36047029700,"Census Tract 297, Kings County, New York",70556,4253,56,3263,2260,207,1993,677
36047029800,"Census Tract 298, Kings County, New York",55060,3794,1337,139,1951,759,1843,1589
36047029900,"Census Tract 299, Kings County, New York",50144,2941,64,2036,1571,746,1370,281
36047030000,"Census Tract 300, Kings County, New York",52663,4207,1947,208,2082,950,2125,1274
36047030100,"Census Tract 301, Kings County, New York",49196,2963,19,2585,1659,465,1304,217
36047030200,"Census Tract 302, Kings County, New York",65000,4448,2594,77,2360,139,2088,1687
36047030300,"Census Tract 303, Kings County, New York",38571,4914,55,3867,2808,1170,2106,224
36047030400,"Census Tract 304, Kings County, New York",41017,4189,1647,137,2302,597,1887,1708
36047030500,"Census Tract 305, Kings County, New York",85985,6528,311,2208,3346,914,3182,3316
36047030600,"Census Tract 306, Kings County, New York",50833,1736,782,7,933,252,803,773
36047030700,"Census Tract 307, Kings County, New York",24502,5954,0,4879,3225,1218,2729,485
36047030800,"Census Tract 308, Kings County, New York",47461,1980,475,25,936,198,1044,1435
36047030900,"Census Tract 309, Kings County, New York",46309,2405,119,1924,1344,286,1061,152
36047031100,"Census Tract 311, Kings County, New York",37014,2924,30,2259,1605,406,1319,285
36047031300,"Census Tract 313, Kings County, New York",51818,5055,108,3754,2616,784,2439,894
36047031400,"Census Tract 314, Kings County, New York",80439,4978,1390,24,2623,268,2355,3450
36047031500,"Census Tract 315, Kings County, New York",63313,4970,218,2216,2379,653,2591,1975
36047031701,"Census Tract 317.01, Kings County, New York",78750,3805,172,2072,2056,267,1749,1291
36047031702,"Census Tract 317.02, Kings County, New York",78355,3315,172,1519,1751,425,1564,1221
36047031900,"Census Tract 319, Kings County, New York",55357,3141,25,1512,1722,202,1419,1454
36047032100,"Census Tract 321, Kings County, New York",57574,5488,175,3431,2837,519,2651,1256
36047032300,"Census Tract 323, Kings County, New York",77645,3506,24,2362,2020,332,1486,988
36047032500,"Census Tract 325, Kings County, New York",51721,6076,158,4934,3210,442,2866,600
36047032600,"Census Tract 326, Kings County, New York",23470,6730,831,2865,4068,1993,2662,1499
36047032700,"Census Tract 327, Kings County, New York",55795,2544,100,1588,1435,469,1109,621
36047032800,"Census Tract 328, Kings County, New York",41353,2688,810,952,1469,581,1219,455
36047032900,"Census Tract 329, Kings County, New York",44922,6105,110,3157,3459,609,2646,2427
36047033000,"Census Tract 330, Kings County, New York",22933,5006,411,2499,2686,1186,2320,1404
36047033100,"Census Tract 331, Kings County, New York",40216,4058,0,1452,1948,155,2110,2596
36047033300,"Census Tract 333, Kings County, New York",49444,4547,10,1148,2495,133,2052,3333
36047033500,"Census Tract 335, Kings County, New York",68036,3034,29,733,1362,50,1672,2150
36047033600,"Census Tract 336, Kings County, New York",82850,4443,315,256,2258,448,2185,3655
36047033700,"Census Tract 337, Kings County, New York",54006,3856,139,1428,2093,734,1763,1670
36047033900,"Census Tract 339, Kings County, New York",40417,4538,391,3054,2276,217,2262,918
36047034000,"Census Tract 340, Kings County, New York",21224,2050,145,829,1175,476,875,960
36047034100,"Census Tract 341, Kings County, New York",51250,3056,45,2177,1505,198,1551,656
36047034200,"Census Tract 342, Kings County, New York",17932,6064,190,2219,3654,1756,2410,2481
36047034300,"Census Tract 343, Kings County, New York",33385,5163,28,3825,3262,1044,1901,724
36047034500,"Census Tract 345, Kings County, New York",44483,3108,16,2156,1630,232,1478,504
36047034700,"Census Tract 347, Kings County, New York",43849,3350,93,2966,1945,443,1405,142
36047034800,"Census Tract 348, Kings County, New York",54405,2885,666,107,1321,1397,1564,875
36047034900,"Census Tract 349, Kings County, New York",41061,6145,105,4861,3490,589,2655,600
36047035000,"Census Tract 350, Kings County, New York",42102,3124,0,18,1707,95,1417,3030
36047035100,"Census Tract 351, Kings County, New York",44624,4650,92,2839,2729,883,1921,1128
36047035200,"Census Tract 352, Kings County, New York",14167,1254,72,235,739,181,515,855
36047035300,"Census Tract 353, Kings County, New York",47321,5407,166,3412,3007,824,2400,1326
36047035400,"Census Tract 354, Kings County, New York",50599,5765,0,55,3260,396,2505,5603
36047035500,"Census Tract 355, Kings County, New York",51875,5631,0,3972,2973,672,2658,1206
36047035601,"Census Tract 356.01, Kings County, New York",32111,2834,0,170,1573,102,1261,2570
36047035602,"Census Tract 356.02, Kings County, New York",45163,5529,137,3,2860,103,2669,5105
36047035700,"Census Tract 357, Kings County, New York",30495,2328,10,1996,1347,373,981,109
36047035900,"Census Tract 359, Kings County, New York",32326,5593,51,4670,3223,693,2370,359
36047036001,"Census Tract 360.01, Kings County, New York",25265,3155,23,28,1726,51,1429,2906
36047036002,"Census Tract 360.02, Kings County, New York",16073,4074,81,15,2386,16,1688,3696
36047036100,"Census Tract 361, Kings County, New York",25694,2787,23,2086,1236,604,1551,292
36047036200,"Census Tract 362, Kings County, New York",42670,3855,799,57,1977,996,1878,2095
36047036300,"Census Tract 363, Kings County, New York",34063,5044,25,4301,2627,792,2417,235
36047036400,"Census Tract 364, Kings County, New York",59712,2443,399,48,1203,278,1240,1637
36047036501,"Census Tract 365.01, Kings County, New York",46538,3417,27,3177,1829,426,1588,19
36047036502,"Census Tract 365.02, Kings County, New York",38750,1415,7,798,776,621,639,226
36047036600,"Census Tract 366, Kings County, New York",48050,4268,1160,87,2184,817,2084,2113
36047036700,"Census Tract 367, Kings County, New York",54432,1281,72,777,594,431,687,126
36047036900,"Census Tract 369, Kings County, New York",35977,5787,95,4131,2743,1225,3044,699
36047037000,"Census Tract 370, Kings County, New York",57888,4231,1211,10,2205,163,2026,2885
36047037100,"Census Tract 371, Kings County, New York",64848,4711,67,3806,2271,806,2440,483
36047037300,"Census Tract 373, Kings County, New York",45179,4486,99,3097,2562,784,1924,906
36047037401,"Census Tract 374.01, Kings County, New York",55341,4376,451,356,2338,151,2038,3069
36047037402,"Census Tract 374.02, Kings County, New York",31832,4937,1086,208,2209,650,2728,2758
36047037500,"Census Tract 375, Kings County, New York",51495,3229,191,1714,1754,670,1475,780
36047037700,"Census Tract 377, Kings County, New York",52367,4541,87,3229,2313,591,2228,595
36047037900,"Census Tract 379, Kings County, New York",46429,4660,44,3762,2574,339,2086,511
36047038100,"Census Tract 381, Kings County, New York",45667,5397,106,4077,3094,690,2303,788
36047038200,"Census Tract 382, Kings County, New York",18169,5740,1525,2415,3466,1968,2274,620
36047038300,"Census Tract 383, Kings County, New York",73641,4720,463,3365,2642,158,2078,624
36047038500,"Census Tract 385, Kings County, New York",79107,3963,219,2787,2052,401,1911,688
36047038600,"Census Tract 386, Kings County, New York",83594,3669,1264,1,1852,1011,1817,1771
36047038700,"Census Tract 387, Kings County, New York",64917,3882,119,2402,2092,667,1790,1049
36047038800,"Census Tract 388, Kings County, New York",64375,4094,538,489,2132,277,1962,2923
36047038900,"Census Tract 389, Kings County, New York",74352,2837,272,256,1419,1436,1418,1424
36047039000,"Census Tract 390, Kings County, New York",70114,2397,63,7,1138,198,1259,2137
36047039100,"Census Tract 391, Kings County, New York",70945,3239,239,386,1572,1984,1667,1470
36047039200,"Census Tract 392, Kings County, New York",64500,2880,199,34,1547,157,1333,2540
36047039300,"Census Tract 393, Kings County, New York",75256,3890,288,783,1767,1883,2123,1863
36047039400,"Census Tract 394, Kings County, New York",46198,2338,19,56,1106,300,1232,2043
36047039500,"Census Tract 395, Kings County, New York",56598,3858,255,1350,1999,1262,1859,1354
36047039600,"Census Tract 396, Kings County, New York",64375,2058,38,0,1030,32,1028,1716
36047039700,"Census Tract 397, Kings County, New York",45685,3553,37,1859,1878,1138,1675,964
36047039800,"Census Tract 398, Kings County, New York",71679,2878,1353,0,1516,598,1362,1022
36047039900,"Census Tract 399, Kings County, New York",51776,3873,23,1546,1943,1908,1930,920
36047040000,"Census Tract 400, Kings County, New York",52125,3003,1348,24,1551,404,1452,1339
36047040100,"Census Tract 401, Kings County, New York",55625,3162,139,1583,1722,952,1440,983
36047040200,"Census Tract 402, Kings County, New York",57404,2988,1486,12,1578,477,1410,1056
36047040300,"Census Tract 403, Kings County, New York",60855,3529,82,2163,1919,964,1610,1042
36047040400,"Census Tract 404, Kings County, New York",61087,2459,1149,36,1196,146,1263,1189
36047040500,"Census Tract 405, Kings County, New York",63438,1513,52,663,781,647,732,282
36047040600,"Census Tract 406, Kings County, New York",52986,3692,1882,41,1906,589,1786,1119
36047040700,"Census Tract 407, Kings County, New York",NA,0,0,0,0,0,0,0
36047040800,"Census Tract 408, Kings County, New York",80169,3646,1828,15,1720,677,1926,1157
36047040900,"Census Tract 409, Kings County, New York",52629,3836,23,1093,1887,2564,1949,1025
36047041000,"Census Tract 410, Kings County, New York",48400,2048,609,19,1034,48,1014,1388
36047041100,"Census Tract 411, Kings County, New York",38214,3034,68,1188,1517,1016,1517,967
36047041200,"Census Tract 412, Kings County, New York",63641,3328,1070,0,1747,341,1581,1836
36047041300,"Census Tract 413, Kings County, New York",63750,3986,223,1631,2124,1967,1862,1261
36047041401,"Census Tract 414.01, Kings County, New York",67972,1541,115,8,819,199,722,1219
36047041402,"Census Tract 414.02, Kings County, New York",52946,1824,0,0,887,171,937,1612
36047041500,"Census Tract 415, Kings County, New York",64844,4353,119,1762,2242,2181,2111,1016
36047041600,"Census Tract 416, Kings County, New York",61414,2338,120,36,1141,236,1197,2086
36047041700,"Census Tract 417, Kings County, New York",24433,3132,177,1166,1642,1906,1490,834
36047041800,"Census Tract 418, Kings County, New York",45536,2960,123,8,1511,428,1449,2520
36047041900,"Census Tract 419, Kings County, New York",56550,3623,216,977,1937,2279,1686,1074
36047042000,"Census Tract 420, Kings County, New York",58571,1837,22,105,910,155,927,1686
36047042100,"Census Tract 421, Kings County, New York",51341,4259,88,551,2077,2855,2182,1574
36047042200,"Census Tract 422, Kings County, New York",59904,3535,156,104,1502,705,2033,2390
36047042300,"Census Tract 423, Kings County, New York",67056,3978,118,256,1986,2313,1992,2218
36047042400,"Census Tract 424, Kings County, New York",61005,3480,848,5,1650,904,1830,1829
36047042500,"Census Tract 425, Kings County, New York",77477,3338,91,408,1530,2043,1808,1413
36047042600,"Census Tract 426, Kings County, New York",49954,4302,1857,81,2359,686,1943,1641
36047042700,"Census Tract 427, Kings County, New York",59965,4896,263,370,2405,2914,2491,2281
36047042800,"Census Tract 428, Kings County, New York",60708,3785,1265,55,2015,120,1770,2147
36047042900,"Census Tract 429, Kings County, New York",50170,5441,282,490,2766,3639,2675,2183
36047043000,"Census Tract 430, Kings County, New York",38160,3283,1408,0,1699,366,1584,1643
36047043100,"Census Tract 431, Kings County, New York",57111,4694,304,133,2297,2790,2397,2317
36047043200,"Census Tract 432, Kings County, New York",63063,4341,1814,45,2150,816,2191,1651
36047043300,"Census Tract 433, Kings County, New York",24766,3628,141,694,1951,2757,1677,914
36047043400,"Census Tract 434, Kings County, New York",49013,3537,1387,124,1853,446,1684,1887
36047043500,"Census Tract 435, Kings County, New York",66923,5115,192,1036,2392,3752,2723,1056
36047043600,"Census Tract 436, Kings County, New York",57901,5059,1269,60,2641,793,2418,3006
36047043700,"Census Tract 437, Kings County, New York",59474,5696,98,1507,2685,3431,3011,2114
36047043800,"Census Tract 438, Kings County, New York",46167,2620,253,53,1352,132,1268,2086
36047043900,"Census Tract 439, Kings County, New York",42148,3515,161,974,1711,2228,1804,1020
36047044000,"Census Tract 440, Kings County, New York",51420,2809,111,89,1416,337,1393,2450
36047044100,"Census Tract 441, Kings County, New York",47754,5124,728,693,2624,3150,2500,1844
36047044200,"Census Tract 442, Kings County, New York",76046,2945,31,2,1475,44,1470,2551
36047044300,"Census Tract 443, Kings County, New York",50263,4587,822,212,2169,2556,2418,1844
36047044400,"Census Tract 444, Kings County, New York",51975,3589,140,232,1892,309,1697,3140
36047044500,"Census Tract 445, Kings County, New York",69414,4729,359,449,2324,3128,2405,1309
36047044600,"Census Tract 446, Kings County, New York",63708,2092,882,26,1067,397,1025,955
36047044700,"Census Tract 447, Kings County, New York",46738,2545,97,561,1389,1319,1156,1099
36047044800,"Census Tract 448, Kings County, New York",60921,1698,171,0,882,94,816,1408
36047044900,"Census Tract 449, Kings County, New York",22102,3210,119,1704,1521,1715,1689,819
36047045000,"Census Tract 450, Kings County, New York",NA,566,16,6,279,25,287,538
36047045200,"Census Tract 452, Kings County, New York",82532,2514,60,21,1300,63,1214,2433
36047045300,"Census Tract 453, Kings County, New York",51953,2578,24,691,962,1162,1616,1153
36047045400,"Census Tract 454, Kings County, New York",66364,1681,87,28,751,80,930,1385
36047045600,"Census Tract 456, Kings County, New York",41806,2170,445,25,1106,108,1064,1242
36047045800,"Census Tract 458, Kings County, New York",86250,1324,0,32,600,154,724,1267
36047046000,"Census Tract 460, Kings County, New York",61023,3131,1064,83,1548,321,1583,1687
36047046201,"Census Tract 462.01, Kings County, New York",29830,2281,337,15,1312,70,969,1876
36047046202,"Census Tract 462.02, Kings County, New York",61250,1942,58,24,1051,177,891,1698
36047046400,"Census Tract 464, Kings County, New York",57283,2638,54,88,1177,121,1461,2391
36047046800,"Census Tract 468, Kings County, New York",72750,2168,49,6,1042,41,1126,2082
36047047000,"Census Tract 470, Kings County, New York",61033,2603,71,3,1165,134,1438,2453
36047047200,"Census Tract 472, Kings County, New York",60054,2769,19,31,1424,8,1345,2711
36047047400,"Census Tract 474, Kings County, New York",38813,2385,0,4,1039,23,1346,2351
36047047600,"Census Tract 476, Kings County, New York",35474,3385,26,78,1474,38,1911,3260
36047047700,"Census Tract 477, Kings County, New York",142250,3835,292,44,2005,373,1830,3286
36047047800,"Census Tract 478, Kings County, New York",48040,3666,263,0,1828,500,1838,3117
36047048000,"Census Tract 480, Kings County, New York",32056,3675,381,124,1616,1119,2059,2338
36047048100,"Census Tract 481, Kings County, New York",91528,2967,351,159,1523,887,1444,2106
36047048200,"Census Tract 482, Kings County, New York",47569,4885,1515,239,2466,840,2419,2765
36047048400,"Census Tract 484, Kings County, New York",50833,5574,709,420,2545,524,3029,3909
36047048500,"Census Tract 485, Kings County, New York",103173,2289,52,160,882,792,1407,1510
36047048600,"Census Tract 486, Kings County, New York",50250,3200,1400,49,1553,764,1647,1173
36047048800,"Census Tract 488, Kings County, New York",54067,3896,932,268,2127,458,1769,2127
36047048900,"Census Tract 489, Kings County, New York",24808,3617,46,1613,2116,2078,1501,831
36047049000,"Census Tract 490, Kings County, New York",59384,5601,1160,541,2932,975,2669,3305
36047049100,"Census Tract 491, Kings County, New York",48566,7069,2243,913,3581,2784,3488,2574
36047049200,"Census Tract 492, Kings County, New York",62604,2688,654,225,1304,256,1384,1653
36047049300,"Census Tract 493, Kings County, New York",28287,7292,247,1968,3818,4074,3474,2644
36047049400,"Census Tract 494, Kings County, New York",76513,5707,1352,312,2679,855,3028,3349
36047049500,"Census Tract 495, Kings County, New York",92120,2600,247,202,1276,615,1324,1812
36047049600,"Census Tract 496, Kings County, New York",77115,4093,1117,145,2097,1257,1996,1883
36047049700,"Census Tract 497, Kings County, New York",91557,2717,335,24,1252,481,1465,2041
36047049800,"Census Tract 498, Kings County, New York",79583,4139,1358,148,2166,679,1973,2020
36047049900,"Census Tract 499, Kings County, New York",76612,1785,105,20,834,185,951,1525
36047050000,"Census Tract 500, Kings County, New York",98421,3953,771,360,2054,474,1899,2550
36047050100,"Census Tract 501, Kings County, New York",112679,3177,196,44,1754,560,1423,2540
36047050202,"Census Tract 502.02, Kings County, New York",102656,2523,101,24,1285,241,1238,2160
36047050300,"Census Tract 503, Kings County, New York",96216,2670,187,59,1484,530,1186,1975
36047050400,"Census Tract 504, Kings County, New York",98525,4741,443,697,2463,817,2278,2942
36047050500,"Census Tract 505, Kings County, New York",41629,4009,558,813,2069,1868,1940,1572
36047050600,"Census Tract 506, Kings County, New York",59882,5205,473,2150,2651,1533,2554,1622
36047050700,"Census Tract 507, Kings County, New York",35469,3063,57,124,1435,535,1628,2478
36047050801,"Census Tract 508.01, Kings County, New York",50333,4075,92,2726,2271,1031,1804,846
36047050803,"Census Tract 508.03, Kings County, New York",55395,2522,93,1590,1329,332,1193,564
36047050804,"Census Tract 508.04, Kings County, New York",60563,6083,161,2843,3270,1884,2813,1544
36047050900,"Census Tract 509, Kings County, New York",37000,5440,0,13,2374,266,3066,5194
36047051001,"Census Tract 510.01, Kings County, New York",55435,4092,74,3191,2196,528,1896,623
36047051002,"Census Tract 510.02, Kings County, New York",50625,4858,86,3009,2562,1087,2296,684
36047051100,"Census Tract 511, Kings County, New York",48476,4333,984,438,2041,1472,2292,2249
36047051200,"Census Tract 512, Kings County, New York",61292,5936,111,3415,3119,1169,2817,1419
36047051300,"Census Tract 513, Kings County, New York",110972,5397,340,238,2858,1802,2539,3967
36047051400,"Census Tract 514, Kings County, New York",64259,7834,1045,3307,4137,2148,3697,1700
36047051500,"Census Tract 515, Kings County, New York",158452,2443,228,150,1214,411,1229,1885
36047051601,"Census Tract 516.01, Kings County, New York",59223,5252,190,3915,3038,1195,2214,517
36047051602,"Census Tract 516.02, Kings County, New York",54879,3895,117,2784,2125,714,1770,323
36047051700,"Census Tract 517, Kings County, New York",126649,2581,262,42,1266,276,1315,2014
36047051800,"Census Tract 518, Kings County, New York",64211,3328,194,1604,1751,461,1577,1155
36047051900,"Census Tract 519, Kings County, New York",143057,5066,435,252,2262,608,2804,4076
36047052000,"Census Tract 520, Kings County, New York",81875,3874,963,495,2094,757,1780,1675
36047052300,"Census Tract 523, Kings County, New York",69950,4854,303,386,2503,2547,2351,3068
36047052500,"Census Tract 525, Kings County, New York",35867,3270,165,234,1622,1091,1648,2409
36047052600,"Census Tract 526, Kings County, New York",68077,4491,613,791,2359,1185,2132,2113
36047052700,"Census Tract 527, Kings County, New York",64167,6490,325,405,3329,4304,3161,3039
36047052800,"Census Tract 528, Kings County, New York",87212,1799,370,108,897,223,902,1184
36047052900,"Census Tract 529, Kings County, New York",27229,3443,0,20,1564,81,1879,3410
36047053000,"Census Tract 530, Kings County, New York",53802,4060,1116,73,2211,492,1849,2626
36047053100,"Census Tract 531, Kings County, New York",47868,8833,64,27,4644,247,4189,8544
36047053200,"Census Tract 532, Kings County, New York",65972,2789,637,218,1511,202,1278,1728
36047053300,"Census Tract 533, Kings County, New York",26976,6754,87,27,3421,81,3333,6629
36047053400,"Census Tract 534, Kings County, New York",39917,4232,907,337,2240,296,1992,2454
36047053500,"Census Tract 535, Kings County, New York",30699,3708,0,160,1894,193,1814,3304
36047053700,"Census Tract 537, Kings County, New York",40644,3862,32,56,1855,28,2007,3763
36047053800,"Census Tract 538, Kings County, New York",55027,5180,561,438,2786,699,2394,3772
36047053900,"Census Tract 539, Kings County, New York",20902,2483,0,90,1280,457,1203,2076
36047054200,"Census Tract 542, Kings County, New York",50694,4008,169,117,2004,375,2004,3519
36047054300,"Census Tract 543, Kings County, New York",116875,283,30,38,116,27,167,183
36047054400,"Census Tract 544, Kings County, New York",60707,3487,665,0,1723,235,1764,2713
36047054500,"Census Tract 545, Kings County, New York",23555,8138,36,1152,4333,1710,3805,5989
36047054600,"Census Tract 546, Kings County, New York",47344,4782,374,194,2524,338,2258,3745
36047054700,"Census Tract 547, Kings County, New York",50272,5724,142,311,3026,1046,2698,4537
36047054800,"Census Tract 548, Kings County, New York",71250,2090,22,4,1116,39,974,1933
36047054900,"Census Tract 549, Kings County, New York",111071,4171,241,55,2084,945,2087,3247
36047055000,"Census Tract 550, Kings County, New York",60851,3382,377,107,1633,428,1749,2622
36047055100,"Census Tract 551, Kings County, New York",89073,5361,161,749,2700,2821,2661,3281
36047055200,"Census Tract 552, Kings County, New York",74395,3477,450,5,1803,349,1674,2687
36047055300,"Census Tract 553, Kings County, New York",120069,2740,125,26,1389,507,1351,2249
36047055400,"Census Tract 554, Kings County, New York",45257,4328,476,10,2276,629,2052,3365
36047055500,"Census Tract 555, Kings County, New York",143833,7696,1201,324,3389,1290,4307,5414
36047055600,"Census Tract 556, Kings County, New York",55995,3397,263,17,1802,344,1595,2959
36047055700,"Census Tract 557, Kings County, New York",92674,1981,142,40,978,579,1003,1666
36047055800,"Census Tract 558, Kings County, New York",76797,2492,403,55,1271,420,1221,1788
36047056000,"Census Tract 560, Kings County, New York",50833,3482,260,20,1797,75,1685,3132
36047056100,"Census Tract 561, Kings County, New York",108750,3538,228,209,1810,223,1728,2825
36047056200,"Census Tract 562, Kings County, New York",88221,1655,84,0,846,29,809,1479
36047056300,"Census Tract 563, Kings County, New York",90948,5390,372,279,2740,1463,2650,3981
36047056400,"Census Tract 564, Kings County, New York",82344,2523,490,29,1235,185,1288,1932
36047056500,"Census Tract 565, Kings County, New York",106157,3156,149,0,1625,545,1531,2630
36047056600,"Census Tract 566, Kings County, New York",83849,2749,647,361,1540,110,1209,1496
36047056800,"Census Tract 568, Kings County, New York",86250,1455,401,0,775,70,680,924
36047056900,"Census Tract 569, Kings County, New York",128036,1691,67,17,869,188,822,1471
36047057000,"Census Tract 570, Kings County, New York",75761,3529,977,113,1902,426,1627,2401
36047057100,"Census Tract 571, Kings County, New York",85510,4038,90,64,2087,349,1951,3658
36047057200,"Census Tract 572, Kings County, New York",24958,5522,515,3034,2996,1582,2526,1284
36047057300,"Census Tract 573, Kings County, New York",102656,2457,132,77,1322,262,1135,1970
36047057400,"Census Tract 574, Kings County, New York",85673,2858,1440,8,1481,131,1377,1331
36047057500,"Census Tract 575, Kings County, New York",87561,3983,112,16,2099,685,1884,3316
36047057600,"Census Tract 576, Kings County, New York",80625,3041,1496,69,1538,243,1503,1272
36047057800,"Census Tract 578, Kings County, New York",47466,3260,975,68,1727,592,1533,1862
36047057900,"Census Tract 579, Kings County, New York",93750,1165,38,147,619,423,546,764
36047058000,"Census Tract 580, Kings County, New York",61184,4402,1875,306,2225,585,2177,1929
36047058200,"Census Tract 582, Kings County, New York",52644,2542,533,70,1296,660,1246,1358
36047058400,"Census Tract 584, Kings County, New York",68487,3479,705,210,1944,326,1535,2364
36047058600,"Census Tract 586, Kings County, New York",71758,2772,1705,84,1413,364,1359,681
36047058800,"Census Tract 588, Kings County, New York",68125,3269,657,50,1799,257,1470,2373
36047058900,"Census Tract 589, Kings County, New York",85500,1691,37,11,884,205,807,1557
36047059000,"Census Tract 590, Kings County, New York",69250,1834,644,64,943,311,891,862
36047059100,"Census Tract 591, Kings County, New York",108447,3638,96,202,1793,544,1845,3209
36047059200,"Census Tract 592, Kings County, New York",53177,4152,787,263,2292,483,1860,2440
36047059300,"Census Tract 593, Kings County, New York",81319,2022,73,58,1001,303,1021,1695
36047059401,"Census Tract 594.01, Kings County, New York",61283,7396,2836,49,3731,361,3665,4240
36047059402,"Census Tract 594.02, Kings County, New York",97500,5399,1369,0,2784,98,2615,3881
36047059600,"Census Tract 596, Kings County, New York",47273,2442,179,173,1293,10,1149,1837
36047059800,"Census Tract 598, Kings County, New York",75612,3606,492,140,1711,187,1895,2665
36047060000,"Census Tract 600, Kings County, New York",72342,6277,660,63,2872,310,3405,5145
36047060600,"Census Tract 606, Kings County, New York",62000,2811,520,14,1490,267,1321,1966
36047060800,"Census Tract 608, Kings County, New York",54360,3545,596,66,1886,313,1659,2698
36047061002,"Census Tract 610.02, Kings County, New York",76378,4898,0,0,2413,78,2485,4840
36047061003,"Census Tract 610.03, Kings County, New York",50887,1669,416,57,875,720,794,835
36047061004,"Census Tract 610.04, Kings County, New York",34432,6221,380,1,3425,458,2796,5129
36047061200,"Census Tract 612, Kings County, New York",92143,1065,0,0,579,55,486,1050
36047061600,"Census Tract 616, Kings County, New York",110170,1465,0,80,731,68,734,1335
36047062000,"Census Tract 620, Kings County, New York",123500,1816,64,0,910,6,906,1752
36047062200,"Census Tract 622, Kings County, New York",74290,2715,156,261,1426,145,1289,2234
36047062600,"Census Tract 626, Kings County, New York",58102,2869,857,166,1573,364,1296,1400
36047062800,"Census Tract 628, Kings County, New York",84091,4418,471,0,2245,397,2173,3854
36047063200,"Census Tract 632, Kings County, New York",68182,1534,213,26,787,89,747,1213
36047063600,"Census Tract 636, Kings County, New York",109479,1289,296,0,718,205,571,956
36047063800,"Census Tract 638, Kings County, New York",103438,2023,468,106,984,205,1039,1423
36047064000,"Census Tract 640, Kings County, New York",120885,1742,180,0,877,273,865,1471
36047064200,"Census Tract 642, Kings County, New York",73583,2227,205,88,1100,221,1127,1755
36047064400,"Census Tract 644, Kings County, New York",89250,2855,625,61,1375,317,1480,2071
36047064600,"Census Tract 646, Kings County, New York",95391,2190,158,77,1104,139,1086,1879
36047064800,"Census Tract 648, Kings County, New York",108438,2194,72,594,1125,100,1069,1487
36047065000,"Census Tract 650, Kings County, New York",81875,1642,298,669,862,419,780,531
36047065200,"Census Tract 652, Kings County, New York",93050,1094,27,38,567,97,527,1021
36047065400,"Census Tract 654, Kings County, New York",97250,1437,230,25,749,68,688,1165
36047065600,"Census Tract 656, Kings County, New York",86897,1725,313,16,867,201,858,1357
36047065800,"Census Tract 658, Kings County, New York",97188,1798,438,47,886,157,912,1245
36047066000,"Census Tract 660, Kings County, New York",124821,2050,303,15,944,101,1106,1602
36047066200,"Census Tract 662, Kings County, New York",88490,1501,277,13,866,176,635,1181
36047066600,"Census Tract 666, Kings County, New York",NA,0,0,0,0,0,0,0
36047067000,"Census Tract 670, Kings County, New York",81250,2934,381,1611,1630,418,1304,693
36047067200,"Census Tract 672, Kings County, New York",84438,1640,191,1175,778,60,862,274
36047067400,"Census Tract 674, Kings County, New York",100139,1920,143,1236,970,244,950,371
36047067600,"Census Tract 676, Kings County, New York",86129,1760,25,1483,869,299,891,126
36047067800,"Census Tract 678, Kings County, New York",96275,2852,0,2536,1602,84,1250,281
36047068000,"Census Tract 680, Kings County, New York",85769,2185,134,1549,1156,403,1029,229
36047068200,"Census Tract 682, Kings County, New York",124306,2832,267,1835,1471,222,1361,578
36047068600,"Census Tract 686, Kings County, New York",69167,1718,86,607,960,174,758,925
36047068800,"Census Tract 688, Kings County, New York",84276,1719,202,874,937,267,782,447
36047069000,"Census Tract 690, Kings County, New York",84856,2082,110,1357,1094,307,988,355
36047069200,"Census Tract 692, Kings County, New York",118065,2734,189,1952,1394,396,1340,206
36047069601,"Census Tract 696.01, Kings County, New York",81106,3248,64,1547,1733,306,1515,1471
36047069602,"Census Tract 696.02, Kings County, New York",77682,5812,340,489,2981,1019,2831,4249
36047069800,"Census Tract 698, Kings County, New York",104141,1449,363,58,753,104,696,892
36047070000,"Census Tract 700, Kings County, New York",92778,1604,25,40,814,66,790,1531
36047070201,"Census Tract 702.01, Kings County, New York",108669,6402,69,288,3387,527,3015,5613
36047070202,"Census Tract 702.02, Kings County, New York",NA,8,0,0,0,0,8,8
36047070203,"Census Tract 702.03, Kings County, New York",NA,0,0,0,0,0,0,0
36047070600,"Census Tract 706, Kings County, New York",112557,3137,150,291,1679,154,1458,2675
36047072000,"Census Tract 720, Kings County, New York",78214,2019,126,1714,1068,163,951,123
36047072200,"Census Tract 722, Kings County, New York",67401,2881,50,2566,1704,368,1177,114
36047072400,"Census Tract 724, Kings County, New York",76618,1979,1,1843,1098,68,881,107
36047072600,"Census Tract 726, Kings County, New York",86500,2343,74,1947,1127,377,1216,74
36047072800,"Census Tract 728, Kings County, New York",80082,3946,19,3730,2477,112,1469,120
36047073000,"Census Tract 730, Kings County, New York",91477,2278,9,2013,1283,181,995,220
36047073200,"Census Tract 732, Kings County, New York",70000,2195,135,1945,1202,114,993,52
36047073400,"Census Tract 734, Kings County, New York",84750,1776,7,1597,880,129,896,72
36047073600,"Census Tract 736, Kings County, New York",75153,3198,345,2305,1580,408,1618,189
36047073800,"Census Tract 738, Kings County, New York",65417,3977,216,1872,2032,779,1945,1342
36047074000,"Census Tract 740, Kings County, New York",71250,3598,505,2419,2039,129,1559,386
36047074200,"Census Tract 742, Kings County, New York",62000,3136,35,1382,1674,136,1462,1495
36047074400,"Census Tract 744, Kings County, New York",119375,2777,74,271,1361,105,1416,2372
36047074600,"Census Tract 746, Kings County, New York",85417,2577,93,510,1131,230,1446,1818
36047074800,"Census Tract 748, Kings County, New York",89917,1957,124,338,977,48,980,1477
36047075000,"Census Tract 750, Kings County, New York",77433,2857,128,364,1364,254,1493,2212
36047075200,"Census Tract 752, Kings County, New York",165263,1031,8,10,495,0,536,1013
36047075400,"Census Tract 754, Kings County, New York",115139,1294,0,11,648,3,646,1280
36047075600,"Census Tract 756, Kings County, New York",110250,2150,263,66,1007,142,1143,1749
36047075800,"Census Tract 758, Kings County, New York",86250,1653,8,26,918,50,735,1458
36047076000,"Census Tract 760, Kings County, New York",67875,2930,120,148,1457,66,1473,2605
36047076200,"Census Tract 762, Kings County, New York",54571,4285,590,734,2134,379,2151,2707
36047076400,"Census Tract 764, Kings County, New York",61250,3602,284,1689,1924,558,1678,1369
36047076600,"Census Tract 766, Kings County, New York",70156,2103,90,1489,1237,228,866,386
36047076800,"Census Tract 768, Kings County, New York",51146,3219,286,72,1559,207,1660,2710
36047077000,"Census Tract 770, Kings County, New York",59231,2820,231,1770,1663,382,1157,575
36047077200,"Census Tract 772, Kings County, New York",64205,3114,53,1346,1889,480,1225,1377
36047077400,"Census Tract 774, Kings County, New York",71929,3250,280,2165,1895,252,1355,571
36047077600,"Census Tract 776, Kings County, New York",72568,3732,316,2964,2229,142,1503,265
36047078000,"Census Tract 780, Kings County, New York",82273,2161,4,2059,1282,96,879,73
36047078200,"Census Tract 782, Kings County, New York",65294,4923,80,4568,2779,219,2144,77
36047078400,"Census Tract 784, Kings County, New York",76417,2386,60,1970,1259,173,1127,142
36047078600,"Census Tract 786, Kings County, New York",56781,4753,266,3438,2702,625,2051,510
36047078800,"Census Tract 788, Kings County, New York",46833,3528,24,3101,1909,220,1619,148
36047079000,"Census Tract 790, Kings County, New York",61201,5096,24,4473,2996,287,2100,194
36047079200,"Census Tract 792, Kings County, New York",62011,3488,29,2577,1919,477,1569,405
36047079400,"Census Tract 794, Kings County, New York",43250,1716,24,1279,919,304,797,189
36047079601,"Census Tract 796.01, Kings County, New York",62775,4536,75,3052,2694,341,1842,1104
36047079602,"Census Tract 796.02, Kings County, New York",65714,4797,135,3176,2608,794,2189,819
36047079801,"Census Tract 798.01, Kings County, New York",76838,2869,70,1471,1451,270,1418,1019
36047079802,"Census Tract 798.02, Kings County, New York",70769,5441,389,2565,2968,1005,2473,1697
36047080000,"Census Tract 800, Kings County, New York",83750,3689,90,2205,1941,308,1748,975
36047080200,"Census Tract 802, Kings County, New York",62050,4578,130,3264,2582,486,1996,778
36047080400,"Census Tract 804, Kings County, New York",53512,3191,52,2565,1679,205,1512,472
36047080600,"Census Tract 806, Kings County, New York",56339,3355,187,1860,1815,170,1540,1175
36047080800,"Census Tract 808, Kings County, New York",11167,1326,118,928,645,211,681,172
36047081000,"Census Tract 810, Kings County, New York",57500,2322,12,1573,1276,128,1046,423
36047081400,"Census Tract 814, Kings County, New York",43962,2770,98,2569,1463,136,1307,58
36047081600,"Census Tract 816, Kings County, New York",42938,2653,143,2008,1476,336,1177,170
36047081800,"Census Tract 818, Kings County, New York",74375,4528,253,3641,2243,243,2285,549
36047082000,"Census Tract 820, Kings County, New York",46992,5175,69,4234,2666,532,2509,208
36047082200,"Census Tract 822, Kings County, New York",51197,7170,75,5719,3621,748,3549,935
36047082400,"Census Tract 824, Kings County, New York",59470,4910,128,4448,2774,339,2136,138
36047082600,"Census Tract 826, Kings County, New York",55000,4911,15,4158,2703,317,2208,457
36047082800,"Census Tract 828, Kings County, New York",55850,3706,79,3079,1941,366,1765,250
36047083000,"Census Tract 830, Kings County, New York",52083,6306,53,5511,3596,859,2710,168
36047083200,"Census Tract 832, Kings County, New York",65406,2127,85,1978,1212,39,915,2
36047083400,"Census Tract 834, Kings County, New York",53578,1745,104,1601,982,33,763,0
36047083600,"Census Tract 836, Kings County, New York",68603,2017,32,1947,1105,48,912,0
36047083800,"Census Tract 838, Kings County, New York",77549,2073,0,1941,1152,75,921,15
36047084000,"Census Tract 840, Kings County, New York",60625,2520,14,2399,1385,137,1135,56
36047084600,"Census Tract 846, Kings County, New York",54153,2023,0,1816,1202,165,821,115
36047084800,"Census Tract 848, Kings County, New York",78125,1701,50,1628,931,90,770,5
36047085000,"Census Tract 850, Kings County, New York",66333,1489,0,1478,809,11,680,5
36047085200,"Census Tract 852, Kings County, New York",NA,26,0,26,15,21,11,0
36047085400,"Census Tract 854, Kings County, New York",59531,1966,6,1702,1151,323,815,99
36047085600,"Census Tract 856, Kings County, New York",61957,3384,46,2943,1858,249,1526,131
36047085800,"Census Tract 858, Kings County, New York",61721,2107,0,1995,1163,150,944,57
36047086000,"Census Tract 860, Kings County, New York",63241,3627,10,3324,2077,282,1550,11
36047086200,"Census Tract 862, Kings County, New York",46250,2821,0,2488,1756,189,1065,136
36047086400,"Census Tract 864, Kings County, New York",49265,2343,0,2311,1280,61,1063,12
36047086600,"Census Tract 866, Kings County, New York",53032,3145,119,2695,1827,284,1318,114
36047086800,"Census Tract 868, Kings County, New York",46318,3413,22,2944,2021,424,1392,118
36047087000,"Census Tract 870, Kings County, New York",43952,3125,0,2868,1638,193,1487,128
36047087200,"Census Tract 872, Kings County, New York",55902,3130,73,2749,1547,206,1583,248
36047087401,"Census Tract 874.01, Kings County, New York",44250,3759,0,3286,2043,248,1716,307
36047087600,"Census Tract 876, Kings County, New York",43625,1709,39,1241,1045,83,664,353
36047087800,"Census Tract 878, Kings County, New York",43721,2647,0,2539,1356,75,1291,47
36047088000,"Census Tract 880, Kings County, New York",49000,2725,7,2435,1667,76,1058,230
36047088200,"Census Tract 882, Kings County, New York",44623,6353,0,5520,3744,786,2609,340
36047088400,"Census Tract 884, Kings County, New York",48664,4401,47,4124,2450,74,1951,92
36047088600,"Census Tract 886, Kings County, New York",35196,4089,67,3561,2375,326,1714,227
36047088800,"Census Tract 888, Kings County, New York",60435,4086,118,3486,2102,482,1984,41
36047089000,"Census Tract 890, Kings County, New York",37746,5912,0,5184,3250,543,2662,537
36047089200,"Census Tract 892, Kings County, New York",27217,3265,0,2734,1864,385,1401,197
36047089400,"Census Tract 894, Kings County, New York",43795,3254,58,2742,1852,309,1402,177
36047089600,"Census Tract 896, Kings County, New York",37955,3160,21,2806,1589,548,1571,209
36047089800,"Census Tract 898, Kings County, New York",52206,1820,11,1576,984,152,836,106
36047090000,"Census Tract 900, Kings County, New York",23685,3912,0,2909,2504,853,1408,292
36047090200,"Census Tract 902, Kings County, New York",36583,3309,216,2283,2067,722,1242,481
36047090600,"Census Tract 906, Kings County, New York",15017,3295,0,2159,1950,1302,1345,375
36047090800,"Census Tract 908, Kings County, New York",9740,5992,151,4013,4058,1889,1934,1039
36047091000,"Census Tract 910, Kings County, New York",11585,4196,0,2848,2469,1629,1727,439
36047091200,"Census Tract 912, Kings County, New York",15256,5589,119,4225,3434,1502,2155,651
36047091600,"Census Tract 916, Kings County, New York",18320,3481,0,2893,2045,704,1436,314
36047091800,"Census Tract 918, Kings County, New York",19634,2250,0,1378,1281,1009,969,177
36047092000,"Census Tract 920, Kings County, New York",28424,2523,114,1930,1614,834,909,86
36047092200,"Census Tract 922, Kings County, New York",42949,2537,33,2276,1292,249,1245,151
36047092400,"Census Tract 924, Kings County, New York",28509,2653,0,2230,1413,478,1240,96
36047092800,"Census Tract 928, Kings County, New York",58171,3022,0,2715,1746,350,1276,70
36047093000,"Census Tract 930, Kings County, New York",75489,3068,14,2967,1599,66,1469,18
36047093200,"Census Tract 932, Kings County, New York",66250,1124,31,1051,685,38,439,35
36047093400,"Census Tract 934, Kings County, New York",72727,2464,0,2344,1293,112,1171,81
36047093600,"Census Tract 936, Kings County, New York",63929,1692,0,1676,854,18,838,13
36047093800,"Census Tract 938, Kings County, New York",75357,2476,8,2382,1420,97,1056,18
36047094401,"Census Tract 944.01, Kings County, New York",82986,3534,22,3272,2031,176,1503,91
36047094402,"Census Tract 944.02, Kings County, New York",23920,3248,47,2798,1907,659,1341,313
36047094600,"Census Tract 946, Kings County, New York",66750,1947,45,1816,1084,74,863,37
36047095000,"Census Tract 950, Kings County, New York",79345,2751,0,2403,1657,165,1094,232
36047095400,"Census Tract 954, Kings County, New York",78386,4289,31,4021,2395,199,1894,24
36047095600,"Census Tract 956, Kings County, New York",67500,4507,76,3975,2554,144,1953,424
36047095800,"Census Tract 958, Kings County, New York",61128,3345,100,3036,1821,88,1524,158
36047096000,"Census Tract 960, Kings County, New York",NA,0,0,0,0,0,0,0
36047096200,"Census Tract 962, Kings County, New York",67024,1838,22,1559,1086,141,752,94
36047096400,"Census Tract 964, Kings County, New York",64833,1978,140,1552,1136,34,842,93
36047096600,"Census Tract 966, Kings County, New York",67667,2634,107,2221,1402,283,1232,77
36047096800,"Census Tract 968, Kings County, New York",93347,1713,28,1416,925,135,788,95
36047097000,"Census Tract 970, Kings County, New York",85221,2868,9,2398,1624,324,1244,260
36047097400,"Census Tract 974, Kings County, New York",64099,2743,77,2136,1576,393,1167,397
36047098200,"Census Tract 982, Kings County, New York",20751,4532,21,3667,2977,986,1555,271
36047098400,"Census Tract 984, Kings County, New York",71875,1998,7,1833,1041,80,957,158
36047098600,"Census Tract 986, Kings County, New York",73654,2856,53,2634,1519,97,1337,80
36047098800,"Census Tract 988, Kings County, New York",75339,3365,281,2554,1978,518,1387,256
36047099000,"Census Tract 990, Kings County, New York",91964,1744,120,1369,872,78,872,182
36047099200,"Census Tract 992, Kings County, New York",89423,2311,46,2150,1218,97,1093,81
36047099400,"Census Tract 994, Kings County, New York",80259,2126,134,1714,1226,92,900,171
36047099600,"Census Tract 996, Kings County, New York",70093,3761,97,3391,2264,143,1497,214
36047099800,"Census Tract 998, Kings County, New York",77066,3588,0,3161,2216,157,1372,267
36047100400,"Census Tract 1004, Kings County, New York",57813,2677,17,2474,1506,61,1171,146
36047100600,"Census Tract 1006, Kings County, New York",77241,2610,48,2233,1538,145,1072,207
36047100800,"Census Tract 1008, Kings County, New York",73889,2250,100,1791,1146,197,1104,256
36047101000,"Census Tract 1010, Kings County, New York",78583,2284,137,1888,1296,98,988,109
36047101200,"Census Tract 1012, Kings County, New York",64569,2288,113,1921,1235,236,1053,128
36047101400,"Census Tract 1014, Kings County, New York",85250,2178,132,1757,1126,166,1052,133
36047101600,"Census Tract 1016, Kings County, New York",100391,1715,0,1621,857,19,858,75
36047101800,"Census Tract 1018, Kings County, New York",84850,2295,217,1874,1250,221,1045,59
36047102000,"Census Tract 1020, Kings County, New York",104148,2217,0,2040,1124,83,1093,80
36047102200,"Census Tract 1022, Kings County, New York",87604,2171,226,1649,1173,83,998,183
36047102400,"Census Tract 1024, Kings County, New York",96875,2255,41,2017,1319,41,936,123
36047102600,"Census Tract 1026, Kings County, New York",103229,3023,66,2713,1763,131,1260,121
36047102800,"Census Tract 1028, Kings County, New York",95486,1680,34,1545,1012,66,668,64
36047103400,"Census Tract 1034, Kings County, New York",25691,4294,0,3313,2748,963,1546,234
36047105801,"Census Tract 1058.01, Kings County, New York",26112,5809,56,3618,3951,1089,1858,1862
36047105804,"Census Tract 1058.04, Kings County, New York",32292,6744,424,3707,3646,1220,3098,1921
36047107000,"Census Tract 1070, Kings County, New York",51549,2330,92,1712,1432,620,898,224
36047107800,"Census Tract 1078, Kings County, New York",63411,4662,0,4054,2562,454,2100,228
36047109800,"Census Tract 1098, Kings County, New York",49440,2359,68,1777,1260,388,1099,246
36047110400,"Census Tract 1104, Kings County, New York",36630,4407,1,3851,2586,709,1821,228
36047110600,"Census Tract 1106, Kings County, New York",19973,4191,9,2964,2705,1299,1486,280
36047111000,"Census Tract 1110, Kings County, New York",21060,2986,22,2096,1652,704,1334,470
36047111600,"Census Tract 1116, Kings County, New York",34413,3624,7,2777,1897,903,1727,625
36047111800,"Census Tract 1118, Kings County, New York",39390,3639,0,2511,2046,998,1593,588
36047112000,"Census Tract 1120, Kings County, New York",36447,3105,59,2115,1788,1131,1317,811
36047112200,"Census Tract 1122, Kings County, New York",41442,3168,170,2407,1853,640,1315,241
36047112400,"Census Tract 1124, Kings County, New York",45213,3054,0,2550,1636,548,1418,95
36047112600,"Census Tract 1126, Kings County, New York",28149,3237,122,2625,1879,423,1358,125
36047112800,"Census Tract 1128, Kings County, New York",35398,3764,0,3211,1934,506,1830,421
36047113000,"Census Tract 1130, Kings County, New York",44872,3699,0,3150,2048,709,1651,192
36047113200,"Census Tract 1132, Kings County, New York",59000,1973,14,1803,1029,205,944,102
36047113400,"Census Tract 1134, Kings County, New York",25469,3105,32,2305,1882,1072,1223,360
36047114201,"Census Tract 1142.01, Kings County, New York",NA,1554,43,499,673,1003,881,351
36047114202,"Census Tract 1142.02, Kings County, New York",67500,3011,0,1592,1610,1717,1401,697
36047114400,"Census Tract 1144, Kings County, New York",53646,2545,17,1414,1573,1154,972,729
36047114600,"Census Tract 1146, Kings County, New York",35109,2852,326,669,1636,1864,1216,852
36047115000,"Census Tract 1150, Kings County, New York",45143,2557,67,1523,1252,1094,1305,366
36047115200,"Census Tract 1152, Kings County, New York",40884,3122,86,1894,1620,971,1502,305
36047115600,"Census Tract 1156, Kings County, New York",21301,3924,20,3285,2553,731,1371,250
36047115800,"Census Tract 1158, Kings County, New York",35495,2878,1,1920,1561,851,1317,235
36047116000,"Census Tract 1160, Kings County, New York",37600,2324,0,1782,1365,733,959,272
36047116200,"Census Tract 1162, Kings County, New York",41618,2429,67,1950,1422,325,1007,101
36047116400,"Census Tract 1164, Kings County, New York",50853,3596,36,2497,1866,1275,1730,643
36047116600,"Census Tract 1166, Kings County, New York",58750,3128,82,1693,1722,1209,1406,746
36047116800,"Census Tract 1168, Kings County, New York",62375,2028,28,821,1062,1202,966,786
36047117000,"Census Tract 1170, Kings County, New York",42411,1791,72,683,973,1347,818,481
36047117201,"Census Tract 1172.01, Kings County, New York",62750,2745,81,530,1452,2147,1293,940
36047117202,"Census Tract 1172.02, Kings County, New York",49615,3756,104,1151,1915,2307,1841,1759
36047117400,"Census Tract 1174, Kings County, New York",64149,4143,291,883,2038,2967,2105,2279
36047117601,"Census Tract 1176.01, Kings County, New York",51583,3203,47,1232,1606,2239,1597,1218
36047117602,"Census Tract 1176.02, Kings County, New York",45457,2841,65,519,1576,2082,1265,1523
36047117800,"Census Tract 1178, Kings County, New York",45417,1694,365,446,824,897,870,615
36047118000,"Census Tract 1180, Kings County, New York",NA,0,0,0,0,0,0,0
36047118201,"Census Tract 1182.01, Kings County, New York",64094,2868,124,733,1504,1803,1364,1509
36047118202,"Census Tract 1182.02, Kings County, New York",57500,3317,152,720,1768,2463,1549,1764
36047118400,"Census Tract 1184, Kings County, New York",58703,5105,451,1416,2633,3617,2472,2146
36047118600,"Census Tract 1186, Kings County, New York",64132,2960,568,968,1421,1328,1539,938
36047118800,"Census Tract 1188, Kings County, New York",51190,4536,1117,1582,2427,1279,2109,1324
36047119000,"Census Tract 1190, Kings County, New York",44821,2220,133,1085,1058,1021,1162,581
36047119200,"Census Tract 1192, Kings County, New York",48000,3090,110,1393,1557,1463,1533,851
36047119400,"Census Tract 1194, Kings County, New York",44444,4892,63,3373,2354,1774,2538,1165
36047119600,"Census Tract 1196, Kings County, New York",39838,4993,615,2851,2411,1325,2582,1148
36047119800,"Census Tract 1198, Kings County, New York",37025,3671,13,1726,1812,1961,1859,806
36047120000,"Census Tract 1200, Kings County, New York",47566,2630,514,1671,1262,487,1368,270
36047120200,"Census Tract 1202, Kings County, New York",32321,1933,696,965,975,280,958,239
36047120800,"Census Tract 1208, Kings County, New York",39002,10413,251,8582,5763,1562,4650,1213
36047121000,"Census Tract 1210, Kings County, New York",15833,4196,14,2659,2691,1751,1505,1062
36047121400,"Census Tract 1214, Kings County, New York",18457,4820,0,2964,2756,2004,2064,905
36047122000,"Census Tract 1220, Kings County, New York",39674,5945,64,5296,3440,641,2505,360
36047123700,"Census Tract 1237, Kings County, New York",47798,6966,54,305,3425,577,3541,6248
36047150200,"Census Tract 1502, Kings County, New York",117639,2651,189,48,1388,287,1263,2252
36047152200,"Census Tract 1522, Kings County, New York",135982,3717,649,814,1915,575,1802,1659
36061000100,"Census Tract 1, New York County, New York",NA,0,0,0,0,0,0,0
36061000201,"Census Tract 2.01, New York County, New York",29500,2750,1194,412,1583,1105,1167,458
36061000202,"Census Tract 2.02, New York County, New York",35466,7773,1579,1668,4373,3038,3400,3205
36061000500,"Census Tract 5, New York County, New York",NA,0,0,0,0,0,0,0
36061000600,"Census Tract 6, New York County, New York",16600,9838,5860,715,5245,2788,4593,1083
36061000700,"Census Tract 7, New York County, New York",184609,8501,1623,72,4632,441,3869,6470
36061000800,"Census Tract 8, New York County, New York",33487,9315,7994,8,4928,412,4387,1024
36061000900,"Census Tract 9, New York County, New York",206750,1796,328,88,831,166,965,1226
36061001001,"Census Tract 10.01, New York County, New York",81250,1546,176,29,645,260,901,1214
36061001002,"Census Tract 10.02, New York County, New York",23230,5157,988,1069,2790,3303,2367,1077
36061001200,"Census Tract 12, New York County, New York",53669,4168,714,117,1977,1210,2191,2456
36061001300,"Census Tract 13, New York County, New York",171173,4455,808,175,2475,420,1980,3110
36061001401,"Census Tract 14.01, New York County, New York",103750,3024,474,108,1776,266,1248,2234
36061001402,"Census Tract 14.02, New York County, New York",27355,2941,893,163,1744,929,1197,1071
36061001501,"Census Tract 15.01, New York County, New York",101037,7398,1966,280,3795,529,3603,4777
36061001502,"Census Tract 15.02, New York County, New York",162158,8309,1350,169,4126,445,4183,6367
36061001600,"Census Tract 16, New York County, New York",46729,6968,5438,174,3580,126,3388,1249
36061001800,"Census Tract 18, New York County, New York",50568,6788,3127,388,3191,816,3597,2515
36061002000,"Census Tract 20, New York County, New York",16653,4586,1025,1004,2911,2561,1675,809
36061002100,"Census Tract 21, New York County, New York",250001,6666,678,379,3220,666,3446,5470
36061002201,"Census Tract 22.01, New York County, New York",30703,6565,1355,877,3801,2898,2764,2232
36061002202,"Census Tract 22.02, New York County, New York",92917,2099,260,241,1023,340,1076,1412
36061002400,"Census Tract 24, New York County, New York",14144,4192,545,669,2320,2815,1872,826
36061002500,"Census Tract 25, New York County, New York",20868,5483,2232,1725,3148,1699,2335,543
36061002601,"Census Tract 26.01, New York County, New York",45410,3488,834,505,1899,1147,1589,1362
36061002602,"Census Tract 26.02, New York County, New York",76028,3946,403,209,1831,784,2115,2548
36061002700,"Census Tract 27, New York County, New York",62083,1341,1024,0,713,24,628,231
36061002800,"Census Tract 28, New York County, New York",44199,6765,1037,1126,3790,2289,2975,3164
36061002900,"Census Tract 29, New York County, New York",27908,5924,3489,657,2348,583,3576,1089
36061003001,"Census Tract 30.01, New York County, New York",70057,3815,530,243,1819,747,1996,2515
36061003002,"Census Tract 30.02, New York County, New York",63750,2939,368,176,1549,760,1390,1976
36061003100,"Census Tract 31, New York County, New York",166786,2525,602,238,1382,247,1143,1544
36061003200,"Census Tract 32, New York County, New York",66648,7814,917,392,3565,812,4249,6255
36061003300,"Census Tract 33, New York County, New York",223438,5224,698,107,2573,228,2651,4148
36061003400,"Census Tract 34, New York County, New York",81541,6569,771,229,3445,1506,3124,4938
36061003601,"Census Tract 36.01, New York County, New York",46500,3132,842,352,1559,1302,1573,1373
36061003602,"Census Tract 36.02, New York County, New York",88594,3212,384,331,1332,435,1880,2290
36061003700,"Census Tract 37, New York County, New York",159514,2666,161,44,1344,120,1322,2260
36061003800,"Census Tract 38, New York County, New York",67036,8927,1288,1267,4217,993,4710,5690
36061003900,"Census Tract 39, New York County, New York",207064,6931,480,300,3945,558,2986,5790
36061004000,"Census Tract 40, New York County, New York",87574,8105,1071,248,3894,786,4211,6315
36061004100,"Census Tract 41, New York County, New York",85000,7997,4583,71,3963,416,4034,3007
36061004200,"Census Tract 42, New York County, New York",148839,5384,1200,308,2780,525,2604,3595
36061004300,"Census Tract 43, New York County, New York",74877,3968,984,89,2133,705,1835,2492
36061004400,"Census Tract 44, New York County, New York",104520,16594,2161,788,9131,1207,7463,12771
36061004500,"Census Tract 45, New York County, New York",107708,980,238,5,450,69,530,681
36061004700,"Census Tract 47, New York County, New York",123707,2474,477,10,1183,152,1291,1829
36061004800,"Census Tract 48, New York County, New York",147500,6230,904,185,3200,472,3030,4857
36061004900,"Census Tract 49, New York County, New York",96287,4404,436,116,2336,338,2068,3665
36061005000,"Census Tract 50, New York County, New York",130938,4748,875,53,2570,138,2178,3758
36061005200,"Census Tract 52, New York County, New York",166094,3321,575,103,1637,163,1684,2523
36061005400,"Census Tract 54, New York County, New York",173309,4768,606,212,2422,193,2346,3726
36061005501,"Census Tract 55.01, New York County, New York",161004,4727,931,212,2537,166,2190,3269
36061005502,"Census Tract 55.02, New York County, New York",126332,1825,41,63,861,134,964,1591
36061005600,"Census Tract 56, New York County, New York",145000,4250,457,213,2179,354,2071,3420
36061005700,"Census Tract 57, New York County, New York",183810,2756,167,57,1480,27,1276,2391
36061005800,"Census Tract 58, New York County, New York",207708,4315,698,0,2147,447,2168,3200
36061005900,"Census Tract 59, New York County, New York",127917,5404,536,121,2899,374,2505,4619
36061006000,"Census Tract 60, New York County, New York",169778,5741,643,252,2952,588,2789,4586
36061006100,"Census Tract 61, New York County, New York",210726,4747,716,274,2484,506,2263,3667
36061006200,"Census Tract 62, New York County, New York",87500,4444,890,1004,1894,538,2550,2289
36061006300,"Census Tract 63, New York County, New York",156975,6393,435,67,3468,300,2925,5592
36061006400,"Census Tract 64, New York County, New York",111074,7643,1218,102,3328,480,4315,5833
36061006500,"Census Tract 65, New York County, New York",106944,6337,798,164,3494,450,2843,5172
36061006600,"Census Tract 66, New York County, New York",80797,11839,2166,1424,5640,1924,6199,7759
36061006700,"Census Tract 67, New York County, New York",107908,5431,217,55,2869,400,2562,4828
36061006800,"Census Tract 68, New York County, New York",128491,7876,1496,798,4189,893,3687,5523
36061006900,"Census Tract 69, New York County, New York",250001,2485,248,24,1138,195,1347,2088
36061007000,"Census Tract 70, New York County, New York",109470,8301,1528,727,4800,488,3501,5865
36061007100,"Census Tract 71, New York County, New York",160614,5530,342,202,3006,217,2524,4699
36061007200,"Census Tract 72, New York County, New York",123066,7642,1965,152,4267,300,3375,5452
36061007300,"Census Tract 73, New York County, New York",119926,5759,273,56,2901,436,2858,5331
36061007400,"Census Tract 74, New York County, New York",156964,4528,758,104,2370,292,2158,3422
36061007500,"Census Tract 75, New York County, New York",137449,3603,184,88,1847,243,1756,3004
36061007600,"Census Tract 76, New York County, New York",100809,2092,797,57,1113,155,979,1114
36061007700,"Census Tract 77, New York County, New York",139815,5971,244,77,2751,450,3220,5351
36061007800,"Census Tract 78, New York County, New York",133778,9422,2197,359,4663,1012,4759,6333
36061007900,"Census Tract 79, New York County, New York",92788,4425,223,37,2432,302,1993,3941
36061008000,"Census Tract 80, New York County, New York",133960,4964,683,61,2496,312,2468,4044
36061008100,"Census Tract 81, New York County, New York",137070,7481,562,257,3454,1199,4027,6256
36061008200,"Census Tract 82, New York County, New York",141141,3241,676,77,1873,333,1368,2291
36061008300,"Census Tract 83, New York County, New York",80221,3686,410,402,1790,1197,1896,2209
36061008400,"Census Tract 84, New York County, New York",158750,1746,649,59,917,143,829,998
36061008601,"Census Tract 86.01, New York County, New York",158125,2915,702,62,1390,112,1525,2074
36061008602,"Census Tract 86.02, New York County, New York",NA,0,0,0,0,0,0,0
36061008603,"Census Tract 86.03, New York County, New York",170781,4400,448,27,2393,467,2007,3686
36061008700,"Census Tract 87, New York County, New York",177188,6556,624,118,3049,685,3507,5397
36061008800,"Census Tract 88, New York County, New York",126788,7416,1842,104,3794,286,3622,5154
36061008900,"Census Tract 89, New York County, New York",106207,5413,533,180,2571,1278,2842,4364
36061009000,"Census Tract 90, New York County, New York",135734,7633,1701,218,4251,482,3382,5591
36061009100,"Census Tract 91, New York County, New York",150349,6298,937,442,2798,343,3500,4692
36061009200,"Census Tract 92, New York County, New York",138971,1474,358,21,741,61,733,1015
36061009300,"Census Tract 93, New York County, New York",76933,9440,1585,696,4590,1755,4850,6512
36061009400,"Census Tract 94, New York County, New York",150893,71,5,0,50,0,21,66
36061009500,"Census Tract 95, New York County, New York",153264,3142,343,92,1820,260,1322,2659
36061009600,"Census Tract 96, New York County, New York",130500,177,51,0,47,8,130,122
36061009700,"Census Tract 97, New York County, New York",61534,4968,961,499,2383,1154,2585,3080
36061009800,"Census Tract 98, New York County, New York",129167,7302,791,153,3664,718,3638,6131
36061009900,"Census Tract 99, New York County, New York",141672,5981,933,327,2676,727,3305,4343
36061010000,"Census Tract 100, New York County, New York",95879,1741,394,28,989,103,752,1238
36061010100,"Census Tract 101, New York County, New York",133409,1373,430,83,587,270,786,660
36061010200,"Census Tract 102, New York County, New York",NA,122,2,7,49,14,73,75
36061010300,"Census Tract 103, New York County, New York",96071,2065,475,132,1040,118,1025,1351
36061010400,"Census Tract 104, New York County, New York",125882,811,156,12,471,73,340,550
36061010601,"Census Tract 106.01, New York County, New York",173898,7091,722,0,3995,154,3096,6264
36061010602,"Census Tract 106.02, New York County, New York",166513,4859,647,171,2796,376,2063,3912
36061010800,"Census Tract 108, New York County, New York",163854,9046,917,153,5075,594,3971,7854
36061010900,"Census Tract 109, New York County, New York",167750,172,28,11,79,13,93,116
36061011000,"Census Tract 110, New York County, New York",149583,7499,1086,264,4218,935,3281,6005
36061011100,"Census Tract 111, New York County, New York",112917,4757,1203,322,2146,725,2611,2901
36061011201,"Census Tract 112.01, New York County, New York",119750,843,114,26,504,58,339,697
36061011202,"Census Tract 112.02, New York County, New York",141563,415,44,15,229,30,186,356
36061011203,"Census Tract 112.03, New York County, New York",159792,1103,234,26,635,17,468,803
36061011300,"Census Tract 113, New York County, New York",95313,98,33,38,23,0,75,15
36061011401,"Census Tract 114.01, New York County, New York",250001,1173,51,8,575,81,598,1058
36061011402,"Census Tract 114.02, New York County, New York",152171,1880,154,11,981,117,899,1565
36061011500,"Census Tract 115, New York County, New York",110845,3663,1253,363,1506,864,2157,1735
36061011600,"Census Tract 116, New York County, New York",92426,3540,584,65,1819,310,1721,2743
36061011700,"Census Tract 117, New York County, New York",159671,4191,809,475,1898,703,2293,2684
36061011800,"Census Tract 118, New York County, New York",141667,8986,1180,48,4833,542,4153,7690
36061011900,"Census Tract 119, New York County, New York",17568,1071,76,473,446,197,625,476
36061012000,"Census Tract 120, New York County, New York",199201,3144,111,210,1845,173,1299,2794
36061012100,"Census Tract 121, New York County, New York",62209,7763,798,492,3720,1711,4043,5848
36061012200,"Census Tract 122, New York County, New York",211705,2473,20,0,1342,210,1131,2403
36061012400,"Census Tract 124, New York County, New York",128415,9782,1221,106,4972,833,4810,7890
36061012500,"Census Tract 125, New York County, New York",120240,2311,648,62,1069,318,1242,1430
36061012600,"Census Tract 126, New York County, New York",101494,12620,991,149,6949,628,5671,10826
36061012700,"Census Tract 127, New York County, New York",91143,6707,775,273,2758,1559,3949,4673
36061012800,"Census Tract 128, New York County, New York",174167,5384,175,12,2837,556,2547,4908
36061012900,"Census Tract 129, New York County, New York",99798,8351,1740,268,3623,1612,4728,5378
36061013000,"Census Tract 130, New York County, New York",196964,3314,144,20,1962,181,1352,3075
36061013100,"Census Tract 131, New York County, New York",119345,2788,678,62,1349,414,1439,1953
36061013200,"Census Tract 132, New York County, New York",108275,10999,550,0,5865,3728,5134,8112
36061013300,"Census Tract 133, New York County, New York",81239,6228,1716,321,2575,1381,3653,3553
36061013400,"Census Tract 134, New York County, New York",107295,11360,1073,537,6209,386,5151,9685
36061013500,"Census Tract 135, New York County, New York",76489,9705,1673,1043,5121,3025,4584,5972
36061013600,"Census Tract 136, New York County, New York",108333,15487,1008,391,8900,1503,6587,13644
36061013700,"Census Tract 137, New York County, New York",180172,5994,748,119,2939,532,3055,4691
36061013800,"Census Tract 138, New York County, New York",137196,12213,1673,225,7246,367,4967,9898
36061013900,"Census Tract 139, New York County, New York",101941,10524,1861,640,4831,1102,5693,7006
36061014000,"Census Tract 140, New York County, New York",137109,7194,405,100,4035,357,3159,6530
36061014200,"Census Tract 142, New York County, New York",191417,5110,526,12,2960,44,2150,4453
36061014300,"Census Tract 143, New York County, New York",NA,2,0,1,2,1,0,1
36061014401,"Census Tract 144.01, New York County, New York",124803,4720,457,33,2606,306,2114,4101
36061014402,"Census Tract 144.02, New York County, New York",131884,6946,573,85,4068,368,2878,6024
36061014500,"Census Tract 145, New York County, New York",182083,6153,1164,410,3216,660,2937,4435
36061014601,"Census Tract 146.01, New York County, New York",139952,4182,762,78,2058,532,2124,3093
36061014602,"Census Tract 146.02, New York County, New York",108623,7831,609,0,4733,687,3098,7072
36061014700,"Census Tract 147, New York County, New York",207857,3475,1017,49,1844,480,1631,2270
36061014801,"Census Tract 148.01, New York County, New York",162857,2810,200,10,1570,191,1240,2403
36061014802,"Census Tract 148.02, New York County, New York",137679,6504,674,33,3648,805,2856,5222
36061014900,"Census Tract 149, New York County, New York",149212,4992,472,73,2821,568,2171,4305
36061015001,"Census Tract 150.01, New York County, New York",161776,2285,203,0,1244,115,1041,2056
36061015002,"Census Tract 150.02, New York County, New York",214831,4578,271,49,2572,338,2006,4175
36061015100,"Census Tract 151, New York County, New York",77547,10143,1651,1740,5903,2810,4240,4720
36061015200,"Census Tract 152, New York County, New York",89868,7816,830,738,4769,2050,3047,5162
36061015300,"Census Tract 153, New York County, New York",156435,9764,999,69,5250,626,4514,8262
36061015400,"Census Tract 154, New York County, New York",100152,14134,1124,677,8002,1520,6132,10999
36061015500,"Census Tract 155, New York County, New York",129779,10290,1450,233,5968,345,4322,8423
36061015601,"Census Tract 156.01, New York County, New York",98766,5130,782,417,2831,809,2299,3684
36061015602,"Census Tract 156.02, New York County, New York",72643,2433,280,680,1481,1068,952,1083
36061015700,"Census Tract 157, New York County, New York",137703,9586,704,364,5119,747,4467,8248
36061015801,"Census Tract 158.01, New York County, New York",161259,5099,581,18,2784,274,2315,4334
36061015802,"Census Tract 158.02, New York County, New York",97455,4353,839,426,2380,735,1973,2651
36061015900,"Census Tract 159, New York County, New York",127969,9517,1027,328,5397,643,4120,7483
36061016001,"Census Tract 160.01, New York County, New York",250001,3465,212,14,1875,293,1590,3073
36061016002,"Census Tract 160.02, New York County, New York",123370,3421,526,78,1700,485,1721,2685
36061016100,"Census Tract 161, New York County, New York",120136,6281,666,221,3439,597,2842,5224
36061016200,"Census Tract 162, New York County, New York",32530,9412,886,4742,5331,3656,4081,2135
36061016300,"Census Tract 163, New York County, New York",125388,7267,578,58,3866,403,3401,6474
36061016400,"Census Tract 164, New York County, New York",28726,7474,1418,2119,4287,3525,3187,2681
36061016500,"Census Tract 165, New York County, New York",183346,6512,454,246,3590,539,2922,5412
36061016600,"Census Tract 166, New York County, New York",40402,6377,308,881,3493,3666,2884,3539
36061016700,"Census Tract 167, New York County, New York",201250,6189,770,78,3473,411,2716,4904
36061016800,"Census Tract 168, New York County, New York",22475,5115,325,1747,2526,2239,2589,2104
36061016900,"Census Tract 169, New York County, New York",128250,8375,852,66,4519,1012,3856,6749
36061017000,"Census Tract 170, New York County, New York",36032,7829,1287,1653,4373,4341,3456,3320
36061017100,"Census Tract 171, New York County, New York",161979,8694,257,144,4951,748,3743,8059
36061017200,"Census Tract 172, New York County, New York",33601,5130,190,1772,2653,2910,2477,1773
36061017300,"Census Tract 173, New York County, New York",135233,7580,1007,339,4483,798,3097,5817
36061017401,"Census Tract 174.01, New York County, New York",22217,4634,289,2192,2743,1934,1891,787
36061017402,"Census Tract 174.02, New York County, New York",47411,2375,208,978,1316,802,1059,721
36061017500,"Census Tract 175, New York County, New York",165234,10558,645,529,5957,887,4601,9074
36061017700,"Census Tract 177, New York County, New York",74897,9265,396,1783,5083,2835,4182,5983
36061017800,"Census Tract 178, New York County, New York",50972,3987,173,1002,1730,2144,2257,1250
36061017900,"Census Tract 179, New York County, New York",95921,8267,768,110,4304,1958,3963,6379
36061018000,"Census Tract 180, New York County, New York",32194,7422,189,2939,3649,4380,3773,2003
36061018100,"Census Tract 181, New York County, New York",96429,8496,526,1151,4424,1400,4072,6153
36061018200,"Census Tract 182, New York County, New York",28235,7902,570,2820,4378,3865,3524,968
36061018300,"Census Tract 183, New York County, New York",117679,7827,389,350,4139,1090,3688,6462
36061018400,"Census Tract 184, New York County, New York",22738,7116,478,2671,3973,3360,3143,1908
36061018500,"Census Tract 185, New York County, New York",129194,4893,570,491,2590,277,2303,3665
36061018600,"Census Tract 186, New York County, New York",34600,6909,220,3474,3731,2687,3178,1765
36061018700,"Census Tract 187, New York County, New York",136146,8608,1093,737,5027,639,3581,6425
36061018800,"Census Tract 188, New York County, New York",41160,5437,179,1326,2640,3200,2797,1392
36061018900,"Census Tract 189, New York County, New York",36250,11654,747,2514,6592,5881,5062,4849
36061019000,"Census Tract 190, New York County, New York",58333,3734,494,2063,2018,574,1716,807
36061019100,"Census Tract 191, New York County, New York",113125,9757,975,1110,5004,1869,4753,7060
36061019200,"Census Tract 192, New York County, New York",20117,3802,267,1736,2143,1747,1659,408
36061019300,"Census Tract 193, New York County, New York",55476,10255,850,2191,5465,3719,4790,4662
36061019400,"Census Tract 194, New York County, New York",20373,6166,45,2078,3369,3897,2797,1364
36061019500,"Census Tract 195, New York County, New York",88785,7167,1016,454,4073,1759,3094,4774
36061019600,"Census Tract 196, New York County, New York",17455,4310,107,1942,1923,2190,2387,679
36061019701,"Census Tract 197.01, New York County, New York",52656,639,185,140,303,105,336,271
36061019702,"Census Tract 197.02, New York County, New York",60647,2478,294,814,1248,617,1230,739
36061019800,"Census Tract 198, New York County, New York",76912,2645,221,1292,1311,490,1334,751
36061019900,"Census Tract 199, New York County, New York",96282,8786,1304,710,4797,1240,3989,6353
36061020000,"Census Tract 200, New York County, New York",72833,3606,97,1979,2038,693,1568,958
36061020101,"Census Tract 201.01, New York County, New York",138750,1854,320,158,954,185,900,1247
36061020102,"Census Tract 201.02, New York County, New York",77750,4137,280,2111,2345,617,1792,1504
36061020300,"Census Tract 203, New York County, New York",52813,3607,764,332,1944,676,1663,2130
36061020500,"Census Tract 205, New York County, New York",121250,5117,780,399,3468,569,1649,3743
36061020600,"Census Tract 206, New York County, New York",31625,3432,82,2051,1586,848,1846,747
36061020701,"Census Tract 207.01, New York County, New York",62802,3041,737,323,1672,557,1369,1556
36061020800,"Census Tract 208, New York County, New York",88091,5432,209,3433,2605,839,2827,1051
36061020901,"Census Tract 209.01, New York County, New York",30208,3511,161,1391,1823,1630,1688,544
36061021000,"Census Tract 210, New York County, New York",32396,7540,196,5491,4748,1938,2792,417
36061021100,"Census Tract 211, New York County, New York",52716,10824,1989,1675,5768,2829,5056,4558
36061021200,"Census Tract 212, New York County, New York",53819,4112,152,2946,2383,631,1729,482
36061021303,"Census Tract 213.03, New York County, New York",43983,6283,422,3018,3106,2014,3177,1338
36061021400,"Census Tract 214, New York County, New York",60863,3373,122,2486,1651,431,1722,442
36061021500,"Census Tract 215, New York County, New York",51719,4396,101,2760,2213,1414,2183,604
36061021600,"Census Tract 216, New York County, New York",70399,8773,522,4293,4632,1552,4141,2544
36061021703,"Census Tract 217.03, New York County, New York",NA,11,0,0,5,6,6,11
36061021800,"Census Tract 218, New York County, New York",49482,6236,134,3828,3167,1131,3069,1555
36061021900,"Census Tract 219, New York County, New York",19907,6008,162,2899,3600,3232,2408,835
36061022000,"Census Tract 220, New York County, New York",69926,6078,466,3277,2884,1141,3194,1609
36061022102,"Census Tract 221.02, New York County, New York",96154,2605,133,1375,1246,345,1359,654
36061022200,"Census Tract 222, New York County, New York",41250,3369,228,1643,1850,362,1519,1210
36061022301,"Census Tract 223.01, New York County, New York",56393,8292,185,1081,4231,6069,4061,3532
36061022302,"Census Tract 223.02, New York County, New York",23527,3175,520,790,1801,1727,1374,659
36061022400,"Census Tract 224, New York County, New York",34263,7586,161,4506,4426,2126,3160,1172
36061022500,"Census Tract 225, New York County, New York",60585,10334,476,2955,5168,5385,5166,2727
36061022600,"Census Tract 226, New York County, New York",51074,4954,165,2936,2486,983,2468,1192
36061022700,"Census Tract 227, New York County, New York",56818,5218,276,2104,2905,1894,2313,1809
36061022800,"Census Tract 228, New York County, New York",70650,6162,135,4297,3456,886,2706,1039
36061022900,"Census Tract 229, New York County, New York",52907,9205,287,1866,4498,5087,4707,3274
36061023000,"Census Tract 230, New York County, New York",36124,8717,165,5797,4807,2157,3910,957
36061023100,"Census Tract 231, New York County, New York",50149,6807,182,2901,3428,2857,3379,1395
36061023200,"Census Tract 232, New York County, New York",36804,9069,148,5850,5318,2944,3751,1177
36061023300,"Census Tract 233, New York County, New York",57389,7220,369,1938,3307,3462,3913,2408
36061023400,"Census Tract 234, New York County, New York",49012,5072,45,3209,2329,1268,2743,1138
36061023501,"Census Tract 235.01, New York County, New York",59405,7044,165,2976,3639,2849,3405,1951
36061023502,"Census Tract 235.02, New York County, New York",39911,1986,64,1428,877,484,1109,321
36061023600,"Census Tract 236, New York County, New York",46761,7761,39,6099,4935,1342,2826,611
36061023700,"Census Tract 237, New York County, New York",45167,6682,248,1593,3153,3516,3529,1855
36061023801,"Census Tract 238.01, New York County, New York",98636,6354,2679,565,3273,515,3081,2505
36061023802,"Census Tract 238.02, New York County, New York",108889,6086,1585,1002,3022,1088,3064,2836
36061023900,"Census Tract 239, New York County, New York",39095,2781,137,900,1385,1375,1396,648
36061024000,"Census Tract 240, New York County, New York",NA,2009,63,1152,282,482,1727,573
36061024100,"Census Tract 241, New York County, New York",55734,8680,413,2257,4373,4894,4307,2537
36061024200,"Census Tract 242, New York County, New York",25773,5003,136,2945,2788,1899,2215,600
36061024301,"Census Tract 243.01, New York County, New York",58077,4658,192,1653,2206,2487,2452,909
36061024302,"Census Tract 243.02, New York County, New York",24286,7756,95,3841,4640,4573,3116,784
36061024500,"Census Tract 245, New York County, New York",49118,14717,339,1823,7336,11507,7381,3290
36061024700,"Census Tract 247, New York County, New York",62031,7303,385,1593,3559,4644,3744,2424
36061024900,"Census Tract 249, New York County, New York",43182,1047,79,194,525,637,522,263
36061025100,"Census Tract 251, New York County, New York",42157,2835,112,534,1336,2054,1499,947
36061025300,"Census Tract 253, New York County, New York",55786,13572,239,1339,6743,11049,6829,4978
36061025500,"Census Tract 255, New York County, New York",66466,5999,1005,351,3191,2949,2808,2802
36061025700,"Census Tract 257, New York County, New York",79722,4625,285,1935,2215,742,2410,1740
36061025900,"Census Tract 259, New York County, New York",63807,3731,169,1637,2015,1189,1716,968
36061026100,"Census Tract 261, New York County, New York",46853,13145,87,1905,6752,11679,6393,2714
36061026300,"Census Tract 263, New York County, New York",42045,9177,248,1001,4850,7437,4327,2391
36061026500,"Census Tract 265, New York County, New York",91004,7951,163,1023,4020,4891,3931,4118
36061026700,"Census Tract 267, New York County, New York",43542,1994,66,67,827,804,1167,1383
36061026900,"Census Tract 269, New York County, New York",42917,8986,269,1093,3838,7481,5148,2246
36061027100,"Census Tract 271, New York County, New York",72596,8806,256,772,4751,5401,4055,4152
36061027300,"Census Tract 273, New York County, New York",89882,6925,163,458,3581,1731,3344,4897
36061027500,"Census Tract 275, New York County, New York",106908,3370,137,60,1854,719,1516,2829
36061027700,"Census Tract 277, New York County, New York",28864,6538,122,1286,3866,4754,2672,2006
36061027900,"Census Tract 279, New York County, New York",48245,12053,228,755,6597,9205,5456,3968
36061028100,"Census Tract 281, New York County, New York",98125,3416,276,290,1821,448,1595,2602
36061028300,"Census Tract 283, New York County, New York",56855,7949,423,850,4269,5482,3680,2773
36061028500,"Census Tract 285, New York County, New York",48504,7907,150,784,4195,6487,3712,1735
36061028700,"Census Tract 287, New York County, New York",60128,4231,68,255,2229,2713,2002,2234
36061029100,"Census Tract 291, New York County, New York",47054,12165,495,2130,6814,10077,5351,3370
36061029300,"Census Tract 293, New York County, New York",42525,9397,90,1191,5312,8219,4085,2704
36061029500,"Census Tract 295, New York County, New York",73514,8182,271,580,4139,4608,4043,4346
36061029700,"Census Tract 297, New York County, New York",NA,22,2,13,6,3,16,4
36061029900,"Census Tract 299, New York County, New York",19189,3737,9,973,2075,2847,1662,1083
36061030300,"Census Tract 303, New York County, New York",70223,4535,197,514,2192,2387,2343,2191
36061030700,"Census Tract 307, New York County, New York",90714,3920,152,498,2044,1156,1876,2578
36061030900,"Census Tract 309, New York County, New York",32295,10593,75,2852,5824,7905,4769,2540
36061031100,"Census Tract 311, New York County, New York",NA,0,0,0,0,0,0,0
36061031703,"Census Tract 317.03, New York County, New York",250001,5783,1150,57,2890,383,2893,4368
36061031704,"Census Tract 317.04, New York County, New York",194153,10224,1900,254,4956,1079,5268,7521
36061031900,"Census Tract 319, New York County, New York",NA,0,0,0,0,0,0,0
36081000100,"Census Tract 1, Queens County, New York",150421,9505,2505,409,4555,966,4950,5771
36081000200,"Census Tract 2, Queens County, New York",70655,3019,523,123,1515,2006,1504,1619
36081000400,"Census Tract 4, Queens County, New York",63462,4476,994,272,2375,3018,2101,1300
36081000600,"Census Tract 6, Queens County, New York",83150,4107,817,224,1986,2765,2121,1375
36081000700,"Census Tract 7, Queens County, New York",134519,6336,1495,128,3077,1146,3259,3835
36081000800,"Census Tract 8, Queens County, New York",66439,3193,676,210,1531,1912,1662,1076
36081001000,"Census Tract 10, Queens County, New York",97702,4618,878,168,2181,3088,2437,2074
36081001200,"Census Tract 12, Queens County, New York",68529,3578,773,145,1762,1999,1816,1412
36081001400,"Census Tract 14, Queens County, New York",71620,4308,791,54,2162,2543,2146,1844
36081001600,"Census Tract 16, Queens County, New York",83816,2420,514,151,1134,1356,1286,719
36081001800,"Census Tract 18, Queens County, New York",69479,2796,513,171,1533,1654,1263,1178
36081001900,"Census Tract 19, Queens County, New York",141914,4358,1837,173,2158,465,2200,1964
36081002000,"Census Tract 20, Queens County, New York",86938,1721,570,19,890,916,831,610
36081002200,"Census Tract 22, Queens County, New York",77813,2314,328,110,1153,1435,1161,1048
36081002400,"Census Tract 24, Queens County, New York",73250,2382,555,130,1155,1364,1227,781
36081002500,"Census Tract 25, Queens County, New York",19178,6802,767,3456,3990,2454,2812,1034
36081002600,"Census Tract 26, Queens County, New York",87019,2272,420,113,1150,1250,1122,1033
36081002800,"Census Tract 28, Queens County, New York",59398,3573,792,199,1639,1880,1934,1249
36081003000,"Census Tract 30, Queens County, New York",60278,1524,247,66,851,756,673,796
36081003100,"Census Tract 31, Queens County, New York",81635,1144,190,39,608,559,536,493
36081003200,"Census Tract 32, Queens County, New York",53600,1764,442,164,919,906,845,716
36081003300,"Census Tract 33, Queens County, New York",89669,3569,1187,98,1686,1026,1883,1394
36081003400,"Census Tract 34, Queens County, New York",76923,2612,504,179,1259,1665,1353,862
36081003600,"Census Tract 36, Queens County, New York",80868,3584,1339,36,1854,1830,1730,1029
36081003700,"Census Tract 37, Queens County, New York",NA,0,0,0,0,0,0,0
36081003800,"Census Tract 38, Queens County, New York",71111,2757,479,286,1409,1705,1348,744
36081003900,"Census Tract 39, Queens County, New York",48269,1439,140,94,693,739,746,764
36081004001,"Census Tract 40.01, Queens County, New York",80192,2365,519,95,1209,1012,1156,1119
36081004002,"Census Tract 40.02, Queens County, New York",64196,1459,492,119,775,599,684,516
36081004200,"Census Tract 42, Queens County, New York",57554,4016,1675,259,1833,1588,2183,648
36081004300,"Census Tract 43, Queens County, New York",22939,2283,255,959,1194,948,1089,486
36081004401,"Census Tract 44.01, Queens County, New York",69583,3732,2211,220,1914,938,1818,622
36081004500,"Census Tract 45, Queens County, New York",76328,3194,698,91,1755,565,1439,2025
36081004700,"Census Tract 47, Queens County, New York",38542,3665,527,1041,2121,1136,1544,1491
36081005000,"Census Tract 50, Queens County, New York",NA,49,0,0,9,40,40,28
36081005100,"Census Tract 51, Queens County, New York",50868,1866,1016,59,892,247,974,646
36081005200,"Census Tract 52, Queens County, New York",62250,2817,1376,204,1458,773,1359,457
36081005300,"Census Tract 53, Queens County, New York",86677,5092,1304,123,2649,885,2443,2407
36081005400,"Census Tract 54, Queens County, New York",77854,5862,1809,513,3278,2187,2584,1939
36081005500,"Census Tract 55, Queens County, New York",71628,952,222,22,422,454,530,394
36081005700,"Census Tract 57, Queens County, New York",68156,4212,1045,138,2013,1417,2199,2133
36081005800,"Census Tract 58, Queens County, New York",90230,6355,877,605,3584,3074,2771,3184
36081005900,"Census Tract 59, Queens County, New York",82208,4057,554,69,1994,928,2063,2789
36081006100,"Census Tract 61, Queens County, New York",77941,5548,1023,191,2994,1234,2554,3822
36081006201,"Census Tract 62.01, Queens County, New York",61514,5593,410,125,3094,1624,2499,4357
36081006202,"Census Tract 62.02, Queens County, New York",53676,6459,454,423,3328,2322,3131,3850
36081006300,"Census Tract 63, Queens County, New York",87719,5690,1057,150,3148,1256,2542,3894
36081006501,"Census Tract 65.01, Queens County, New York",77372,3450,474,122,1695,814,1755,2332
36081006502,"Census Tract 65.02, Queens County, New York",84070,3494,324,120,1903,938,1591,2541
36081006900,"Census Tract 69, Queens County, New York",79953,3699,750,198,1777,968,1922,2252
36081007100,"Census Tract 71, Queens County, New York",76420,3344,496,143,1737,598,1607,2309
36081007300,"Census Tract 73, Queens County, New York",81963,3933,960,94,2333,757,1600,2330
36081007500,"Census Tract 75, Queens County, New York",75982,3959,969,55,2285,580,1674,2696
36081007700,"Census Tract 77, Queens County, New York",92500,1856,437,17,891,572,965,940
36081007900,"Census Tract 79, Queens County, New York",68463,2685,684,0,1376,643,1309,1563
36081008100,"Census Tract 81, Queens County, New York",84375,1269,156,44,567,544,702,723
36081008300,"Census Tract 83, Queens County, New York",60951,2409,461,120,1067,925,1342,1139
36081008500,"Census Tract 85, Queens County, New York",48203,883,143,64,535,353,348,447
36081008600,"Census Tract 86, Queens County, New York",77545,2846,522,22,1445,1336,1401,1241
36081008700,"Census Tract 87, Queens County, New York",26750,4052,127,1798,2077,1791,1975,1384
36081008800,"Census Tract 88, Queens County, New York",76875,3663,455,227,1927,1853,1736,2221
36081009100,"Census Tract 91, Queens County, New York",71767,2303,274,89,1045,793,1258,1729
36081009400,"Census Tract 94, Queens County, New York",62308,2769,1368,272,1361,768,1408,472
36081009500,"Census Tract 95, Queens County, New York",82500,2276,361,85,1128,320,1148,1684
36081009600,"Census Tract 96, Queens County, New York",91125,3522,911,377,1751,810,1771,830
36081009700,"Census Tract 97, Queens County, New York",91675,3693,557,69,1584,412,2109,2794
36081009800,"Census Tract 98, Queens County, New York",76917,2705,991,380,1515,435,1190,181
36081009900,"Census Tract 99, Queens County, New York",NA,0,0,0,0,0,0,0
36081010000,"Census Tract 100, Queens County, New York",109583,3686,1095,454,1717,1104,1969,1102
36081010100,"Census Tract 101, Queens County, New York",67273,2382,218,103,1335,221,1047,1851
36081010200,"Census Tract 102, Queens County, New York",67404,2817,1259,387,1527,614,1290,369
36081010300,"Census Tract 103, Queens County, New York",72941,4136,605,124,2069,846,2067,3195
36081010400,"Census Tract 104, Queens County, New York",67083,3014,747,740,1598,377,1416,299
36081010500,"Census Tract 105, Queens County, New York",65551,4522,876,148,2173,1316,2349,2976
36081010600,"Census Tract 106, Queens County, New York",66094,3733,1837,457,1981,422,1752,303
36081010701,"Census Tract 107.01, Queens County, New York",NA,0,0,0,0,0,0,0
36081010800,"Census Tract 108, Queens County, New York",67617,3364,1509,250,1549,638,1815,177
36081011000,"Census Tract 110, Queens County, New York",81667,3234,929,268,1593,1076,1641,666
36081011100,"Census Tract 111, Queens County, New York",81250,3116,364,77,1739,787,1377,2463
36081011200,"Census Tract 112, Queens County, New York",63472,2279,905,93,1160,531,1119,713
36081011300,"Census Tract 113, Queens County, New York",83146,4463,565,91,2112,1343,2351,3339
36081011400,"Census Tract 114, Queens County, New York",49223,1303,370,86,642,512,661,610
36081011500,"Census Tract 115, Queens County, New York",81458,2438,223,7,1254,476,1184,1837
36081011600,"Census Tract 116, Queens County, New York",80313,1980,876,107,998,713,982,451
36081011700,"Census Tract 117, Queens County, New York",85833,3574,301,81,1601,545,1973,3067
36081011800,"Census Tract 118, Queens County, New York",70333,2522,988,147,1070,943,1452,371
36081011900,"Census Tract 119, Queens County, New York",68897,1409,83,0,666,346,743,961
36081012000,"Census Tract 120, Queens County, New York",62105,2365,1122,134,1062,769,1303,441
36081012100,"Census Tract 121, Queens County, New York",83056,2034,114,103,963,347,1071,1658
36081012200,"Census Tract 122, Queens County, New York",72552,3128,1491,135,1499,1015,1629,574
36081012301,"Census Tract 123.01, Queens County, New York",96086,2782,203,108,1404,611,1378,2208
36081012400,"Census Tract 124, Queens County, New York",76758,3374,621,424,1782,1586,1592,911
36081012500,"Census Tract 125, Queens County, New York",83984,1762,206,90,827,398,935,1273
36081012601,"Census Tract 126.01, Queens County, New York",73634,2750,459,207,1380,1545,1370,1136
36081012602,"Census Tract 126.02, Queens County, New York",54899,2792,640,80,1428,1669,1364,1073
36081012800,"Census Tract 128, Queens County, New York",66250,2380,352,191,1293,1308,1087,1402
36081013000,"Census Tract 130, Queens County, New York",73147,1688,452,166,806,324,882,869
36081013200,"Census Tract 132, Queens County, New York",68359,2265,274,86,1231,973,1034,1615
36081013400,"Census Tract 134, Queens County, New York",57891,4678,607,672,2333,1349,2345,2620
36081013500,"Census Tract 135, Queens County, New York",78681,1306,58,5,628,140,678,1203
36081013600,"Census Tract 136, Queens County, New York",76538,1874,123,112,1010,434,864,1452
36081013700,"Census Tract 137, Queens County, New York",97100,1773,113,14,848,258,925,1505
36081013800,"Census Tract 138, Queens County, New York",68125,3608,920,191,1875,991,1733,1766
36081014000,"Census Tract 140, Queens County, New York",71439,3766,605,209,1761,962,2005,2159
36081014100,"Census Tract 141, Queens County, New York",66923,1636,110,33,795,562,841,1046
36081014201,"Census Tract 142.01, Queens County, New York",68657,4334,1445,525,2154,1815,2180,1097
36081014202,"Census Tract 142.02, Queens County, New York",67614,2856,730,311,1374,1343,1482,878
36081014300,"Census Tract 143, Queens County, New York",70197,3772,556,105,1855,950,1917,2518
36081014400,"Census Tract 144, Queens County, New York",56875,1915,569,192,916,807,999,724
36081014500,"Census Tract 145, Queens County, New York",74926,2412,144,82,1213,626,1199,1946
36081014700,"Census Tract 147, Queens County, New York",83333,2768,422,86,1504,357,1264,2098
36081014800,"Census Tract 148, Queens County, New York",64901,1719,751,248,943,416,776,198
36081014900,"Census Tract 149, Queens County, New York",69659,1842,152,16,986,549,856,1468
36081015000,"Census Tract 150, Queens County, New York",92438,2899,1044,461,1344,495,1555,106
36081015100,"Census Tract 151, Queens County, New York",69083,2613,260,56,1300,568,1313,2053
36081015200,"Census Tract 152, Queens County, New York",64643,2822,910,544,1297,813,1525,346
36081015300,"Census Tract 153, Queens County, New York",80161,1933,425,93,958,411,975,1109
36081015400,"Census Tract 154, Queens County, New York",75118,2170,872,259,988,249,1182,140
36081015500,"Census Tract 155, Queens County, New York",95208,2358,427,78,1147,459,1211,1536
36081015600,"Census Tract 156, Queens County, New York",69152,2908,1095,531,1508,400,1400,234
36081015700,"Census Tract 157, Queens County, New York",62500,1305,331,54,626,477,679,615
36081015801,"Census Tract 158.01, Queens County, New York",80507,3746,1240,937,1885,360,1861,161
36081015802,"Census Tract 158.02, Queens County, New York",85494,4872,1136,1176,2447,797,2425,281
36081015900,"Census Tract 159, Queens County, New York",63818,3422,443,11,1815,710,1607,2415
36081016100,"Census Tract 161, Queens County, New York",74453,2297,424,53,1024,933,1273,1383
36081016300,"Census Tract 163, Queens County, New York",22317,3519,492,1009,2002,1673,1517,1611
36081016400,"Census Tract 164, Queens County, New York",79938,3786,1296,744,1933,687,1853,195
36081016600,"Census Tract 166, Queens County, New York",68229,3984,1378,568,2007,1285,1977,529
36081016800,"Census Tract 168, Queens County, New York",96607,3257,1033,715,1597,782,1660,491
36081016900,"Census Tract 169, Queens County, New York",58066,5683,1297,161,2716,1723,2967,3829
36081017000,"Census Tract 170, Queens County, New York",70147,2622,1154,639,1245,215,1377,148
36081017100,"Census Tract 171, Queens County, New York",NA,51,13,10,22,0,29,27
36081017200,"Census Tract 172, Queens County, New York",70804,1913,487,725,981,338,932,89
36081017400,"Census Tract 174, Queens County, New York",77875,2285,500,905,1141,501,1144,335
36081017600,"Census Tract 176, Queens County, New York",68167,2135,390,1040,1074,354,1061,296
36081017800,"Census Tract 178, Queens County, New York",72708,2257,341,850,1181,653,1076,362
36081017900,"Census Tract 179, Queens County, New York",48950,1019,385,46,435,308,584,505
36081018000,"Census Tract 180, Queens County, New York",73500,1328,164,426,624,234,704,338
36081018101,"Census Tract 181.01, Queens County, New York",63068,3497,875,50,1688,1312,1809,1825
36081018102,"Census Tract 181.02, Queens County, New York",70135,3311,670,72,1621,872,1690,2234
36081018200,"Census Tract 182, Queens County, New York",63958,2499,315,1429,1200,472,1299,177
36081018300,"Census Tract 183, Queens County, New York",75453,6064,1404,185,3056,1795,3008,4029
36081018401,"Census Tract 184.01, Queens County, New York",66806,2114,53,1616,1318,293,796,15
36081018402,"Census Tract 184.02, Queens County, New York",72137,2431,157,1754,1262,317,1169,228
36081018501,"Census Tract 185.01, Queens County, New York",58500,3182,613,165,1531,1047,1651,1981
36081018502,"Census Tract 185.02, Queens County, New York",74799,3367,714,98,1657,969,1710,2177
36081018600,"Census Tract 186, Queens County, New York",65875,1869,169,1266,1014,196,855,57
36081018700,"Census Tract 187, Queens County, New York",70326,3069,1148,76,1322,868,1747,1536
36081018800,"Census Tract 188, Queens County, New York",81579,1449,156,967,631,246,818,136
36081018900,"Census Tract 189, Queens County, New York",72453,3136,1233,37,1595,940,1541,1197
36081019000,"Census Tract 190, Queens County, New York",88365,2455,140,1383,1251,457,1204,126
36081019200,"Census Tract 192, Queens County, New York",64627,1969,154,1387,1072,338,897,168
36081019400,"Census Tract 194, Queens County, New York",75069,2892,508,1393,1419,325,1473,119
36081019600,"Census Tract 196, Queens County, New York",71548,3050,251,1695,1786,370,1264,71
36081019800,"Census Tract 198, Queens County, New York",67938,2917,597,1523,1445,546,1472,74
36081019900,"Census Tract 199, Queens County, New York",41250,697,145,260,142,215,555,177
36081020200,"Census Tract 202, Queens County, New York",81667,1762,311,958,1122,174,640,39
36081020400,"Census Tract 204, Queens County, New York",68147,2350,460,930,1159,689,1191,146
36081020500,"Census Tract 205, Queens County, New York",56389,1176,140,81,529,942,647,735
36081020600,"Census Tract 206, Queens County, New York",67298,1855,401,402,914,739,941,211
36081020800,"Census Tract 208, Queens County, New York",84653,3136,289,715,1462,1055,1674,575
36081021200,"Census Tract 212, Queens County, New York",43889,2434,102,291,1142,1650,1292,471
36081021400,"Census Tract 214, Queens County, New York",56194,6984,3222,809,3271,1943,3713,683
36081021600,"Census Tract 216, Queens County, New York",77579,4123,761,438,2194,1361,1929,2289
36081021900,"Census Tract 219, Queens County, New York",NA,0,0,0,0,0,0,0
36081022001,"Census Tract 220.01, Queens County, New York",76330,6272,1353,963,3107,2113,3165,2926
36081022002,"Census Tract 220.02, Queens County, New York",71643,7128,1354,1332,3666,2133,3462,2556
36081022900,"Census Tract 229, Queens County, New York",NA,0,0,0,0,0,0,0
36081023000,"Census Tract 230, Queens County, New York",94667,2054,714,115,919,632,1135,824
36081023200,"Census Tract 232, Queens County, New York",70268,5644,1892,956,2799,1235,2845,1265
36081023500,"Census Tract 235, Queens County, New York",49544,7766,2206,93,3928,4379,3838,3970
36081023600,"Census Tract 236, Queens County, New York",69046,3143,1314,290,1501,1110,1642,638
36081023800,"Census Tract 238, Queens County, New York",51823,4516,1273,642,2045,2143,2471,229
36081024000,"Census Tract 240, Queens County, New York",45400,6826,2101,1167,3388,3231,3438,489
36081024300,"Census Tract 243, Queens County, New York",69583,5088,1673,78,2494,1891,2594,2864
36081024500,"Census Tract 245, Queens County, New York",57817,4422,976,36,2359,1148,2063,2751
36081024600,"Census Tract 246, Queens County, New York",NA,0,0,0,0,0,0,0
36081024700,"Census Tract 247, Queens County, New York",71591,1466,745,0,613,513,853,385
36081024900,"Census Tract 249, Queens County, New York",56853,4838,2607,117,2476,1285,2362,1767
36081025100,"Census Tract 251, Queens County, New York",64763,5611,1595,132,2772,1930,2839,3347
36081025301,"Census Tract 253.01, Queens County, New York",63864,4386,1103,40,2280,1537,2106,2774
36081025302,"Census Tract 253.02, Queens County, New York",64743,3046,555,13,1360,1579,1686,2177
36081025400,"Census Tract 254, Queens County, New York",37897,10118,1132,5777,5664,1970,4454,471
36081025500,"Census Tract 255, Queens County, New York",78088,1524,589,0,727,554,797,809
36081025700,"Census Tract 257, Queens County, New York",71875,1500,642,50,688,468,812,685
36081025800,"Census Tract 258, Queens County, New York",67875,2261,54,1712,1244,176,1017,70
36081025900,"Census Tract 259, Queens County, New York",70337,3486,1330,14,1664,1484,1822,1810
36081026000,"Census Tract 260, Queens County, New York",62585,2757,302,1817,1490,489,1267,64
36081026100,"Census Tract 261, Queens County, New York",54200,6508,3036,298,3521,2775,2987,2188
36081026200,"Census Tract 262, Queens County, New York",72344,1270,69,954,626,229,644,30
36081026300,"Census Tract 263, Queens County, New York",52015,5857,3281,0,3058,1648,2799,2079
36081026400,"Census Tract 264, Queens County, New York",55590,2501,231,1700,1375,544,1126,19
36081026500,"Census Tract 265, Queens County, New York",54091,3722,2491,34,1730,832,1992,904
36081026600,"Census Tract 266, Queens County, New York",28969,1745,104,1452,931,176,814,42
36081026700,"Census Tract 267, Queens County, New York",50613,5353,2480,110,2851,2296,2502,933
36081026901,"Census Tract 269.01, Queens County, New York",57359,4965,1671,34,2529,2994,2436,1050
36081026902,"Census Tract 269.02, Queens County, New York",51406,3603,1767,44,1920,1586,1683,662
36081027000,"Census Tract 270, Queens County, New York",96920,2190,84,1673,1138,341,1052,97
36081027100,"Census Tract 271, Queens County, New York",54665,8428,3441,200,3908,4385,4520,1755
36081027200,"Census Tract 272, Queens County, New York",63917,1970,162,1431,1081,329,889,17
36081027300,"Census Tract 273, Queens County, New York",47943,7116,1124,543,3624,5397,3492,3282
36081027400,"Census Tract 274, Queens County, New York",75380,1718,95,1234,1116,234,602,59
36081027500,"Census Tract 275, Queens County, New York",53764,6820,600,241,3082,5652,3738,4022
36081027600,"Census Tract 276, Queens County, New York",57368,1342,59,1161,694,82,648,53
36081027700,"Census Tract 277, Queens County, New York",51901,7747,1274,147,3554,5584,4193,4174
36081027800,"Census Tract 278, Queens County, New York",42857,2339,17,1821,1322,419,1017,115
36081027900,"Census Tract 279, Queens County, New York",60911,6220,743,243,3020,4216,3200,3763
36081028000,"Census Tract 280, Queens County, New York",64911,1670,0,1564,964,56,706,14
36081028100,"Census Tract 281, Queens County, New York",60720,5013,717,55,2897,2525,2116,3527
36081028200,"Census Tract 282, Queens County, New York",76434,1894,87,1472,979,92,915,41
36081028300,"Census Tract 283, Queens County, New York",65929,7508,1035,93,3920,4751,3588,4719
36081028400,"Census Tract 284, Queens County, New York",90257,4166,94,3515,1988,179,2178,117
36081028500,"Census Tract 285, Queens County, New York",78508,4987,839,93,2749,2101,2238,3328
36081028700,"Census Tract 287, Queens County, New York",66016,6293,1656,37,3195,2668,3098,3348
36081028800,"Census Tract 288, Queens County, New York",71518,4616,564,3182,2309,613,2307,254
36081028900,"Census Tract 289, Queens County, New York",68089,5158,1790,71,2603,1728,2555,2453
36081029100,"Census Tract 291, Queens County, New York",57989,6368,3735,122,2984,1591,3384,1551
36081029300,"Census Tract 293, Queens County, New York",65982,1090,799,0,486,184,604,185
36081029400,"Census Tract 294, Queens County, New York",78199,7000,377,6009,3442,694,3558,378
36081029500,"Census Tract 295, Queens County, New York",69534,3602,1144,67,1779,869,1823,1762
36081029700,"Census Tract 297, Queens County, New York",64135,2038,483,12,1001,970,1037,1217
36081029900,"Census Tract 299, Queens County, New York",NA,0,0,0,0,0,0,0
36081030600,"Census Tract 306, Queens County, New York",76755,4760,172,4149,2506,314,2254,227
36081030902,"Census Tract 309.02, Queens County, New York",49451,6590,2600,272,3199,2266,3391,2702
36081030903,"Census Tract 309.03, Queens County, New York",78590,5722,2216,181,2903,2688,2819,1662
36081030904,"Census Tract 309.04, Queens County, New York",70481,3179,789,24,1743,1335,1436,1546
36081031700,"Census Tract 317, Queens County, New York",62021,5568,346,326,2836,867,2732,4668
36081032000,"Census Tract 320, Queens County, New York",78355,4930,104,4164,2938,572,1992,295
36081032700,"Census Tract 327, Queens County, New York",58145,3702,968,65,1763,2296,1939,1006
36081032800,"Census Tract 328, Queens County, New York",99167,2769,131,2435,1512,147,1257,34
36081032900,"Census Tract 329, Queens County, New York",55395,3244,910,232,1723,1673,1521,1074
36081033000,"Census Tract 330, Queens County, New York",80833,7192,43,6763,3918,425,3274,120
36081033100,"Census Tract 331, Queens County, New York",NA,0,0,0,0,0,0,0
36081033401,"Census Tract 334.01, Queens County, New York",81311,3767,134,3140,2124,490,1643,35
36081033402,"Census Tract 334.02, Queens County, New York",55594,12854,62,12171,7929,501,4925,193
36081033700,"Census Tract 337, Queens County, New York",73231,2999,721,0,1495,2101,1504,1041
36081033900,"Census Tract 339, Queens County, New York",48182,2677,655,97,1336,1457,1341,1131
36081034700,"Census Tract 347, Queens County, New York",55492,2966,463,374,1239,1818,1727,770
36081035100,"Census Tract 351, Queens County, New York",46920,3737,505,369,1798,2467,1939,1346
36081035200,"Census Tract 352, Queens County, New York",93750,2780,80,2355,1583,199,1197,202
36081035300,"Census Tract 353, Queens County, New York",49750,2273,148,296,1210,1742,1063,530
36081035700,"Census Tract 357, Queens County, New York",64167,3710,415,1401,1936,1336,1774,1105
36081035800,"Census Tract 358, Queens County, New York",95000,4179,23,3791,2339,464,1840,191
36081036100,"Census Tract 361, Queens County, New York",47419,2238,323,412,1110,1449,1128,284
36081036300,"Census Tract 363, Queens County, New York",57802,1771,115,263,857,1290,914,285
36081036500,"Census Tract 365, Queens County, New York",51250,2992,198,405,1505,2389,1487,388
36081036600,"Census Tract 366, Queens County, New York",68264,2731,101,2452,1418,193,1313,91
36081036700,"Census Tract 367, Queens County, New York",52955,2178,230,932,1009,891,1169,394
36081036800,"Census Tract 368, Queens County, New York",72000,2495,0,2266,1359,231,1136,27
36081037100,"Census Tract 371, Queens County, New York",67419,1335,200,310,687,724,648,157
36081037300,"Census Tract 373, Queens County, New York",48913,2255,318,320,1166,1497,1089,303
36081037500,"Census Tract 375, Queens County, New York",56875,4116,222,362,1682,3530,2434,1298
36081037600,"Census Tract 376, Queens County, New York",81625,6121,75,5605,3336,226,2785,135
36081037700,"Census Tract 377, Queens County, New York",71728,3620,152,268,1544,3260,2076,1100
36081037900,"Census Tract 379, Queens County, New York",72799,6851,638,378,3281,5962,3570,2659
36081038100,"Census Tract 381, Queens County, New York",61635,7216,367,883,3387,5918,3829,3132
36081038301,"Census Tract 383.01, Queens County, New York",NA,0,0,0,0,0,0,0
36081038302,"Census Tract 383.02, Queens County, New York",NA,0,0,0,0,0,0,0
36081038400,"Census Tract 384, Queens County, New York",75114,2411,15,2313,1240,98,1171,46
36081039400,"Census Tract 394, Queens County, New York",79650,2986,63,2643,1487,254,1499,32
36081039800,"Census Tract 398, Queens County, New York",100063,1675,44,1505,851,109,824,99
36081039900,"Census Tract 399, Queens County, New York",70282,3862,126,399,1759,3225,2103,1860
36081040000,"Census Tract 400, Queens County, New York",100813,1529,0,1315,779,150,750,12
36081040100,"Census Tract 401, Queens County, New York",59214,7686,970,183,3482,6619,4204,2817
36081040200,"Census Tract 402, Queens County, New York",101538,1640,64,1492,852,48,788,9
36081040300,"Census Tract 403, Queens County, New York",60550,7324,1118,79,3462,6150,3862,2647
36081040400,"Census Tract 404, Queens County, New York",71066,4138,279,3408,2352,360,1786,73
36081040500,"Census Tract 405, Queens County, New York",60833,3377,359,198,1556,3001,1821,1360
36081040700,"Census Tract 407, Queens County, New York",53211,9109,361,304,4267,8317,4842,1662
36081040900,"Census Tract 409, Queens County, New York",56101,5560,386,237,2393,4932,3167,1981
36081041100,"Census Tract 411, Queens County, New York",68629,3775,765,119,1719,3005,2056,1036
36081041300,"Census Tract 413, Queens County, New York",55046,4696,957,63,2267,3650,2429,1609
36081041400,"Census Tract 414, Queens County, New York",58885,4551,274,3273,2348,646,2203,255
36081041500,"Census Tract 415, Queens County, New York",51203,4358,464,81,2219,3594,2139,2207
36081042400,"Census Tract 424, Queens County, New York",90125,2414,37,2200,1392,43,1022,23
36081042600,"Census Tract 426, Queens County, New York",NA,477,29,247,35,31,442,201
36081042700,"Census Tract 427, Queens County, New York",63781,4955,376,26,2210,4387,2745,2316
36081043200,"Census Tract 432, Queens County, New York",77734,1244,78,1138,639,33,605,12
36081043400,"Census Tract 434, Queens County, New York",104063,1795,0,1479,970,158,825,84
36081043701,"Census Tract 437.01, Queens County, New York",64946,2686,158,230,1298,1794,1388,1314
36081043702,"Census Tract 437.02, Queens County, New York",44085,7125,922,752,4072,5258,3053,3067
36081043900,"Census Tract 439, Queens County, New York",35771,3610,442,49,1608,2982,2002,2069
36081044000,"Census Tract 440, Queens County, New York",68633,3980,341,2830,2169,616,1811,102
36081044301,"Census Tract 443.01, Queens County, New York",21699,3719,397,255,1896,2903,1823,1778
36081044302,"Census Tract 443.02, Queens County, New York",47411,4076,1879,480,1904,1754,2172,774
36081044400,"Census Tract 444, Queens County, New York",50320,3529,1097,547,1868,1307,1661,391
36081044601,"Census Tract 446.01, Queens County, New York",38229,3361,562,996,1913,1543,1448,323
36081044602,"Census Tract 446.02, Queens County, New York",41415,4961,2438,1031,2907,1209,2054,574
36081044800,"Census Tract 448, Queens County, New York",64500,2809,1443,75,1459,739,1350,281
36081045000,"Census Tract 450, Queens County, New York",84435,2167,1012,238,1208,429,959,514
36081045200,"Census Tract 452, Queens County, New York",70625,1335,670,134,728,258,607,250
36081045400,"Census Tract 454, Queens County, New York",49968,4779,3201,609,2378,478,2401,372
36081045500,"Census Tract 455, Queens County, New York",48889,14284,2558,5094,7401,5332,6883,4255
36081045600,"Census Tract 456, Queens County, New York",91346,1446,1062,19,734,213,712,158
36081045700,"Census Tract 457, Queens County, New York",59318,3281,2052,0,1668,990,1613,313
36081045800,"Census Tract 458, Queens County, New York",72772,2348,1480,303,1189,192,1159,394
36081045900,"Census Tract 459, Queens County, New York",74375,3719,1950,63,1691,1703,2028,345
36081046000,"Census Tract 460, Queens County, New York",50346,6049,2801,942,3073,2045,2976,637
36081046100,"Census Tract 461, Queens County, New York",65547,2464,862,36,984,1268,1480,534
36081046200,"Census Tract 462, Queens County, New York",50670,6907,2915,926,3992,2319,2915,327
36081046300,"Census Tract 463, Queens County, New York",58621,3836,1414,28,1783,2121,2053,632
36081046400,"Census Tract 464, Queens County, New York",90227,1999,661,485,1061,499,938,532
36081046500,"Census Tract 465, Queens County, New York",59318,4172,1062,9,1889,3074,2283,1205
36081046600,"Census Tract 466, Queens County, New York",63284,3882,1578,962,1993,846,1889,556
36081046700,"Census Tract 467, Queens County, New York",40152,5895,1588,64,3013,4150,2882,1965
36081046800,"Census Tract 468, Queens County, New York",73512,3340,2238,429,1762,200,1578,128
36081046900,"Census Tract 469, Queens County, New York",44450,8207,2794,231,4708,4746,3499,998
36081047000,"Census Tract 470, Queens County, New York",65000,3197,1604,291,1717,809,1480,183
36081047100,"Census Tract 471, Queens County, New York",47083,4320,3127,11,2229,1083,2091,362
36081047200,"Census Tract 472, Queens County, New York",70462,3664,1256,1013,1931,502,1733,941
36081047300,"Census Tract 473, Queens County, New York",56605,4328,3019,44,2336,603,1992,858
36081047500,"Census Tract 475, Queens County, New York",59076,4301,2572,57,2201,1305,2100,581
36081047600,"Census Tract 476, Queens County, New York",126053,1419,593,190,685,188,734,473
36081047800,"Census Tract 478, Queens County, New York",69965,4925,1657,1472,2349,660,2576,930
36081047900,"Census Tract 479, Queens County, New York",58690,5115,3523,66,2559,996,2556,796
36081048000,"Census Tract 480, Queens County, New York",71481,2293,937,302,1100,536,1193,317
36081048100,"Census Tract 481, Queens County, New York",45864,6434,3163,266,3146,2419,3288,1067
36081048200,"Census Tract 482, Queens County, New York",70978,1427,374,519,676,128,751,146
36081048300,"Census Tract 483, Queens County, New York",63811,3888,2359,42,1847,1160,2041,774
36081048400,"Census Tract 484, Queens County, New York",87014,5140,1878,1727,2632,549,2508,271
36081048500,"Census Tract 485, Queens County, New York",65284,4366,2890,50,2207,1082,2159,541
36081048900,"Census Tract 489, Queens County, New York",64708,1610,736,13,694,721,916,426
36081049200,"Census Tract 492, Queens County, New York",74150,5444,1722,2428,2702,773,2742,566
36081049301,"Census Tract 493.01, Queens County, New York",66071,2209,738,13,1204,672,1005,1111
36081049302,"Census Tract 493.02, Queens County, New York",73523,3068,501,84,1638,1305,1430,1932
36081049500,"Census Tract 495, Queens County, New York",75500,1515,133,88,816,298,699,1262
36081049600,"Census Tract 496, Queens County, New York",93295,3146,921,807,1519,660,1627,298
36081049700,"Census Tract 497, Queens County, New York",83355,3131,1190,27,1451,799,1680,1580
36081049900,"Census Tract 499, Queens County, New York",61534,5260,3436,53,2758,795,2502,1009
36081050000,"Census Tract 500, Queens County, New York",56150,4279,381,3026,1986,566,2293,342
36081050201,"Census Tract 502.01, Queens County, New York",71250,1384,83,1025,769,243,615,35
36081050202,"Census Tract 502.02, Queens County, New York",76313,1421,127,1008,797,146,624,24
36081050400,"Census Tract 504, Queens County, New York",77794,1818,30,1587,1064,67,754,100
36081050500,"Census Tract 505, Queens County, New York",72000,1529,563,50,836,221,693,757
36081050600,"Census Tract 506, Queens County, New York",85370,1421,196,1101,817,148,604,35
36081050700,"Census Tract 507, Queens County, New York",57153,4102,1299,76,2292,830,1810,2250
36081050800,"Census Tract 508, Queens County, New York",64920,2008,52,1668,993,85,1015,57
36081051000,"Census Tract 510, Queens County, New York",90104,1816,52,1651,1045,79,771,79
36081051100,"Census Tract 511, Queens County, New York",95333,2290,252,18,1234,667,1056,1639
36081051200,"Census Tract 512, Queens County, New York",85000,2512,149,1912,1354,284,1158,14
36081051300,"Census Tract 513, Queens County, New York",91218,2439,389,85,1290,517,1149,1756
36081051500,"Census Tract 515, Queens County, New York",82487,3446,275,17,1756,912,1690,2643
36081051600,"Census Tract 516, Queens County, New York",87773,2183,0,1797,984,298,1199,228
36081051700,"Census Tract 517, Queens County, New York",86513,2007,80,0,1047,618,960,1755
36081051800,"Census Tract 518, Queens County, New York",77462,2181,7,2093,1235,54,946,23
36081052000,"Census Tract 520, Queens County, New York",76576,1410,5,1170,821,68,589,36
36081052100,"Census Tract 521, Queens County, New York",93500,2253,138,29,1090,559,1163,1876
36081052200,"Census Tract 522, Queens County, New York",91313,1760,58,1646,926,114,834,0
36081052400,"Census Tract 524, Queens County, New York",91172,1988,41,1735,1049,198,939,149
36081052500,"Census Tract 525, Queens County, New York",73333,2543,140,119,1218,896,1325,1747
36081052600,"Census Tract 526, Queens County, New York",76731,1933,45,1530,1036,159,897,142
36081052800,"Census Tract 528, Queens County, New York",83250,1434,19,1212,832,111,602,0
36081053000,"Census Tract 530, Queens County, New York",81848,2473,0,2380,1301,42,1172,43
36081053100,"Census Tract 531, Queens County, New York",63447,3417,189,70,1647,980,1770,2439
36081053200,"Census Tract 532, Queens County, New York",84946,1996,1,1621,1085,158,911,15
36081053401,"Census Tract 534.01, Queens County, New York",92961,2125,0,1828,1152,303,973,201
36081053500,"Census Tract 535, Queens County, New York",65208,1432,0,0,663,999,769,1021
36081053601,"Census Tract 536.01, Queens County, New York",101136,2099,94,1518,1127,339,972,110
36081053800,"Census Tract 538, Queens County, New York",101741,1781,75,1506,936,184,845,15
36081053900,"Census Tract 539, Queens County, New York",83566,4433,844,182,2191,2022,2242,2943
36081054000,"Census Tract 540, Queens County, New York",69191,4290,236,2585,2329,913,1961,41
36081054200,"Census Tract 542, Queens County, New York",72966,4737,1080,1246,2497,1112,2240,1139
36081054500,"Census Tract 545, Queens County, New York",59187,4039,101,133,1980,2788,2059,3137
36081054700,"Census Tract 547, Queens County, New York",76493,5048,562,132,2346,3184,2702,3823
36081054800,"Census Tract 548, Queens County, New York",74167,2354,1301,259,1166,398,1188,181
36081054900,"Census Tract 549, Queens County, New York",75500,6437,915,83,2917,4011,3520,4923
36081055100,"Census Tract 551, Queens County, New York",75280,4244,471,255,2279,1838,1965,3245
36081055200,"Census Tract 552, Queens County, New York",63261,2955,532,775,1610,977,1345,501
36081055300,"Census Tract 553, Queens County, New York",59907,2786,458,127,1509,1562,1277,1657
36081055400,"Census Tract 554, Queens County, New York",74821,2530,1131,357,1314,550,1216,682
36081055500,"Census Tract 555, Queens County, New York",64423,2335,146,109,1112,1514,1223,1759
36081055600,"Census Tract 556, Queens County, New York",77829,2282,758,383,1198,488,1084,412
36081055700,"Census Tract 557, Queens County, New York",65799,4275,193,143,2276,2704,1999,3674
36081055800,"Census Tract 558, Queens County, New York",95735,1702,496,295,932,379,770,281
36081055900,"Census Tract 559, Queens County, New York",70000,1184,56,43,571,850,613,812
36081056000,"Census Tract 560, Queens County, New York",70313,1809,593,178,898,606,911,530
36081056100,"Census Tract 561, Queens County, New York",NA,17,8,0,4,9,13,9
36081056200,"Census Tract 562, Queens County, New York",99231,1631,455,207,824,389,807,461
36081056400,"Census Tract 564, Queens County, New York",57132,1178,295,134,592,324,586,287
36081056500,"Census Tract 565, Queens County, New York",71719,1569,39,55,707,1116,862,1123
36081056600,"Census Tract 566, Queens County, New York",77031,1316,382,393,638,285,678,249
36081056700,"Census Tract 567, Queens County, New York",96970,5175,176,128,2417,3319,2758,4079
36081056800,"Census Tract 568, Queens County, New York",83295,5039,411,2963,2583,1048,2456,406
36081057700,"Census Tract 577, Queens County, New York",65607,4169,67,53,2255,1645,1914,3669
36081057900,"Census Tract 579, Queens County, New York",59306,1643,62,20,825,654,818,1375
36081058000,"Census Tract 580, Queens County, New York",87986,4140,59,3196,2189,475,1951,162
36081058100,"Census Tract 581, Queens County, New York",75665,3048,73,80,1460,1231,1588,2735
36081058200,"Census Tract 582, Queens County, New York",100505,4838,171,3891,2673,457,2165,129
36081058300,"Census Tract 583, Queens County, New York",89028,3736,334,81,1906,1225,1830,2766
36081058500,"Census Tract 585, Queens County, New York",79898,4464,512,168,2279,1627,2185,3459
36081058700,"Census Tract 587, Queens County, New York",69358,3550,83,39,1900,937,1650,2966
36081058900,"Census Tract 589, Queens County, New York",62083,5296,160,34,2669,2390,2627,4644
36081059000,"Census Tract 590, Queens County, New York",75750,1466,30,1169,941,129,525,116
36081059100,"Census Tract 591, Queens County, New York",70867,5736,150,243,3022,2625,2714,4577
36081059200,"Census Tract 592, Queens County, New York",115625,1516,0,1403,801,86,715,11
36081059300,"Census Tract 593, Queens County, New York",70962,4217,255,24,2052,1238,2165,3506
36081059400,"Census Tract 594, Queens County, New York",130500,1768,5,1681,906,101,862,12
36081059500,"Census Tract 595, Queens County, New York",72292,5533,217,80,2964,2579,2569,4147
36081059600,"Census Tract 596, Queens County, New York",72578,1272,1,1229,702,66,570,18
36081059800,"Census Tract 598, Queens County, New York",88438,1798,0,1633,944,69,854,31
36081059900,"Census Tract 599, Queens County, New York",65446,1255,78,24,621,288,634,1069
36081060000,"Census Tract 600, Queens County, New York",96875,1102,4,1006,579,77,523,8
36081060100,"Census Tract 601, Queens County, New York",69052,2324,76,42,1222,1022,1102,1739
36081060300,"Census Tract 603, Queens County, New York",89375,2095,81,0,1063,753,1032,1801
36081060600,"Census Tract 606, Queens County, New York",88214,1351,0,1303,859,0,492,6
36081060701,"Census Tract 607.01, Queens County, New York",NA,14,0,0,0,0,14,14
36081060800,"Census Tract 608, Queens County, New York",98750,1564,0,1470,808,60,756,76
36081061000,"Census Tract 610, Queens County, New York",103333,1551,0,1542,791,25,760,9
36081061200,"Census Tract 612, Queens County, New York",121645,2022,0,2003,1160,9,862,4
36081061301,"Census Tract 613.01, Queens County, New York",73860,5742,333,34,2892,2308,2850,4707
36081061302,"Census Tract 613.02, Queens County, New York",NA,0,0,0,0,0,0,0
36081061400,"Census Tract 614, Queens County, New York",125114,1414,32,1249,690,151,724,3
36081061601,"Census Tract 616.01, Queens County, New York",85987,2145,14,1994,1107,249,1038,131
36081061602,"Census Tract 616.02, Queens County, New York",108676,1118,42,940,568,47,550,44
36081061800,"Census Tract 618, Queens County, New York",81406,1796,19,1658,985,89,811,94
36081061900,"Census Tract 619, Queens County, New York",91750,2683,81,45,1249,520,1434,2469
36081062000,"Census Tract 620, Queens County, New York",113125,1431,0,1268,784,129,647,43
36081062100,"Census Tract 621, Queens County, New York",68558,2896,73,77,1619,1182,1277,2330
36081062200,"Census Tract 622, Queens County, New York",103977,2083,13,1795,1037,275,1046,113
36081062300,"Census Tract 623, Queens County, New York",87333,2246,16,147,1119,785,1127,2030
36081062400,"Census Tract 624, Queens County, New York",NA,0,0,0,0,0,0,0
36081062500,"Census Tract 625, Queens County, New York",86607,2692,8,105,1320,1030,1372,2489
36081062600,"Census Tract 626, Queens County, New York",83083,2805,8,2477,1436,272,1369,61
36081062700,"Census Tract 627, Queens County, New York",76859,2944,41,1,1347,1433,1597,2757
36081062900,"Census Tract 629, Queens County, New York",80573,3034,252,54,1550,941,1484,2451
36081063000,"Census Tract 630, Queens County, New York",112438,1503,21,1443,706,19,797,26
36081063200,"Census Tract 632, Queens County, New York",112273,2601,0,2395,1382,140,1219,77
36081063301,"Census Tract 633.01, Queens County, New York",80156,1704,59,47,879,456,825,1564
36081063302,"Census Tract 633.02, Queens County, New York",85000,1475,5,7,780,262,695,1386
36081063500,"Census Tract 635, Queens County, New York",75288,2551,57,10,1397,719,1154,2214
36081063700,"Census Tract 637, Queens County, New York",97356,3432,204,166,1690,812,1742,3014
36081063800,"Census Tract 638, Queens County, New York",101957,3516,24,2924,1864,500,1652,265
36081063900,"Census Tract 639, Queens County, New York",77179,3043,307,156,1683,859,1360,2163
36081064101,"Census Tract 641.01, Queens County, New York",70769,2388,368,17,1182,505,1206,1741
36081064102,"Census Tract 641.02, Queens County, New York",NA,0,0,0,0,0,0,0
36081064500,"Census Tract 645, Queens County, New York",77364,1927,337,96,992,462,935,1241
36081064600,"Census Tract 646, Queens County, New York",87823,2976,29,2709,1499,114,1477,41
36081065000,"Census Tract 650, Queens County, New York",93409,2742,0,2537,1435,84,1307,97
36081065400,"Census Tract 654, Queens County, New York",99792,3782,104,2871,2102,871,1680,524
36081065501,"Census Tract 655.01, Queens County, New York",NA,0,0,0,0,0,0,0
36081065600,"Census Tract 656, Queens County, New York",80604,4966,107,4052,2839,506,2127,281
36081065702,"Census Tract 657.02, Queens County, New York",71382,1802,36,0,947,509,855,1509
36081065703,"Census Tract 657.03, Queens County, New York",85795,2746,94,14,1502,470,1244,2483
36081065900,"Census Tract 659, Queens County, New York",100039,1884,160,0,1052,156,832,1623
36081066000,"Census Tract 660, Queens County, New York",68403,3318,79,2654,1811,469,1507,201
36081066100,"Census Tract 661, Queens County, New York",88636,1647,27,41,915,188,732,1534
36081066300,"Census Tract 663, Queens County, New York",110000,2771,456,5,1459,171,1312,2187
36081066400,"Census Tract 664, Queens County, New York",92912,9980,282,8679,5456,609,4524,435
36081066501,"Census Tract 665.01, Queens County, New York",102708,4149,75,33,2099,674,2050,3407
36081066701,"Census Tract 667.01, Queens County, New York",86563,2800,82,0,1638,676,1162,2447
36081066900,"Census Tract 669, Queens County, New York",70875,1642,107,0,900,143,742,1493
36081067100,"Census Tract 671, Queens County, New York",108438,2455,649,0,1330,144,1125,1666
36081067700,"Census Tract 677, Queens County, New York",101000,1883,254,0,1048,114,835,1596
36081067900,"Census Tract 679, Queens County, New York",48640,4344,310,77,2196,1826,2148,2651
36081068000,"Census Tract 680, Queens County, New York",101458,5299,50,5109,2832,205,2467,45
36081068200,"Census Tract 682, Queens County, New York",89000,994,24,862,533,108,461,20
36081068300,"Census Tract 683, Queens County, New York",51491,3970,1638,384,1976,1435,1994,937
36081068700,"Census Tract 687, Queens County, New York",60855,4188,1695,103,2425,826,1763,1997
36081069000,"Census Tract 690, Queens County, New York",96875,3752,20,3331,2128,22,1624,118
36081069300,"Census Tract 693, Queens County, New York",62476,3151,1124,406,1726,561,1425,1213
36081069400,"Census Tract 694, Queens County, New York",82332,3455,64,2939,1973,379,1482,204
36081069500,"Census Tract 695, Queens County, New York",73984,2211,766,18,1150,393,1061,1355
36081069701,"Census Tract 697.01, Queens County, New York",86875,4322,1249,339,2345,1002,1977,2402
36081069702,"Census Tract 697.02, Queens County, New York",87168,3518,1528,14,1814,489,1704,1816
36081070300,"Census Tract 703, Queens County, New York",68846,2103,591,73,1149,489,954,1186
36081070700,"Census Tract 707, Queens County, New York",112738,2547,821,19,1262,416,1285,1393
36081070900,"Census Tract 709, Queens County, New York",97026,2869,1039,60,1534,238,1335,1463
36081071100,"Census Tract 711, Queens County, New York",95368,6448,1787,107,3319,1043,3129,4032
36081071303,"Census Tract 713.03, Queens County, New York",95045,5431,1021,109,2760,834,2671,3837
36081071304,"Census Tract 713.04, Queens County, New York",55363,6054,1591,106,3143,738,2911,3996
36081071305,"Census Tract 713.05, Queens County, New York",81746,4862,1351,157,2728,914,2134,3124
36081071306,"Census Tract 713.06, Queens County, New York",82205,6361,1672,130,3355,1139,3006,3614
36081071600,"Census Tract 716, Queens County, New York",NA,0,0,0,0,0,0,0
36081071701,"Census Tract 717.01, Queens County, New York",58941,4805,1698,251,2390,587,2415,2586
36081071702,"Census Tract 717.02, Queens County, New York",59667,3915,1816,392,2136,335,1779,1292
36081071900,"Census Tract 719, Queens County, New York",45924,2438,648,129,1310,420,1128,1342
36081072100,"Census Tract 721, Queens County, New York",63561,4579,960,104,2536,626,2043,3035
36081072300,"Census Tract 723, Queens County, New York",118438,2050,673,77,1113,163,937,1263
36081072900,"Census Tract 729, Queens County, New York",128867,1437,575,45,748,121,689,756
36081073100,"Census Tract 731, Queens County, New York",95536,1507,468,0,871,72,636,978
36081073700,"Census Tract 737, Queens County, New York",83634,1930,566,31,1051,243,879,1206
36081073900,"Census Tract 739, Queens County, New York",97716,5425,1692,250,2937,755,2488,3085
36081074100,"Census Tract 741, Queens County, New York",78750,3060,727,133,1784,379,1276,1963
36081074300,"Census Tract 743, Queens County, New York",69138,4082,1064,113,2161,629,1921,2366
36081074500,"Census Tract 745, Queens County, New York",44006,4014,665,227,1907,643,2107,2759
36081074700,"Census Tract 747, Queens County, New York",86034,3705,1580,59,2159,1009,1546,1629
36081074900,"Census Tract 749, Queens County, New York",163750,1429,307,0,750,71,679,1065
36081075701,"Census Tract 757.01, Queens County, New York",96179,5022,1827,94,2829,638,2193,2782
36081075702,"Census Tract 757.02, Queens County, New York",108990,4898,1758,71,2772,346,2126,2729
36081076901,"Census Tract 769.01, Queens County, New York",88971,4407,1163,170,2264,827,2143,2415
36081076902,"Census Tract 769.02, Queens County, New York",65000,1186,352,3,634,307,552,747
36081077300,"Census Tract 773, Queens County, New York",73500,2093,328,96,1029,478,1064,1430
36081077500,"Census Tract 775, Queens County, New York",86319,2234,162,69,1102,402,1132,1851
36081077902,"Census Tract 779.02, Queens County, New York",84375,4829,554,78,2345,67,2484,3975
36081077903,"Census Tract 779.03, Queens County, New York",80325,3166,467,31,1587,747,1579,2240
36081077904,"Census Tract 779.04, Queens County, New York",78348,5781,1650,83,3148,520,2633,3564
36081077905,"Census Tract 779.05, Queens County, New York",82355,2626,452,474,1479,764,1147,1288
36081077906,"Census Tract 779.06, Queens County, New York",64614,3388,1334,93,1692,191,1696,1819
36081077907,"Census Tract 779.07, Queens County, New York",57827,3500,100,327,1562,427,1938,2852
36081077908,"Census Tract 779.08, Queens County, New York",51500,3760,673,922,1461,951,2299,1480
36081078800,"Census Tract 788, Queens County, New York",93807,1865,56,1371,867,136,998,90
36081079000,"Census Tract 790, Queens County, New York",75000,2633,227,1563,1330,419,1303,61
36081079200,"Census Tract 792, Queens County, New York",81438,2414,462,1019,1221,241,1193,59
36081079300,"Census Tract 793, Queens County, New York",NA,0,0,0,0,0,0,0
36081079701,"Census Tract 797.01, Queens County, New York",32017,6676,5304,204,3940,406,2736,514
36081079702,"Census Tract 797.02, Queens County, New York",39553,4502,3532,19,2312,479,2190,595
36081079900,"Census Tract 799, Queens County, New York",46597,3101,2206,0,1456,640,1645,589
36081080301,"Census Tract 803.01, Queens County, New York",58298,3859,2413,105,1933,774,1926,565
36081080302,"Census Tract 803.02, Queens County, New York",66629,3476,2278,33,1763,529,1713,985
36081080900,"Census Tract 809, Queens County, New York",70110,7240,2335,594,4284,1247,2956,3555
36081081400,"Census Tract 814, Queens County, New York",91189,4117,1203,1933,2007,882,2110,426
36081081800,"Census Tract 818, Queens County, New York",69262,3909,1006,1411,1914,846,1995,560
36081083700,"Census Tract 837, Queens County, New York",53707,5283,4336,25,2656,513,2627,626
36081083800,"Census Tract 838, Queens County, New York",98484,5260,2099,598,2566,1764,2694,1502
36081084000,"Census Tract 840, Queens County, New York",72418,6027,2300,1223,3360,1466,2667,843
36081084500,"Census Tract 845, Queens County, New York",34043,4863,2902,529,2564,1093,2299,661
36081084601,"Census Tract 846.01, Queens County, New York",94297,3268,1280,295,1673,820,1595,728
36081084602,"Census Tract 846.02, Queens County, New York",65893,925,261,298,350,186,575,155
36081084900,"Census Tract 849, Queens County, New York",33088,6909,5012,548,3511,1317,3398,262
36081085300,"Census Tract 853, Queens County, New York",34525,5563,5096,38,3212,228,2351,315
36081085500,"Census Tract 855, Queens County, New York",38270,6772,4224,213,3686,1632,3086,867
36081085700,"Census Tract 857, Queens County, New York",42841,5171,3996,97,2668,675,2503,602
36081085900,"Census Tract 859, Queens County, New York",58609,5492,3959,188,2881,764,2611,854
36081086100,"Census Tract 861, Queens County, New York",48990,2032,1476,69,1064,381,968,350
36081086300,"Census Tract 863, Queens County, New York",42743,6613,4539,222,3739,1344,2874,1011
36081086400,"Census Tract 864, Queens County, New York",75741,2727,892,238,1370,1087,1357,712
36081086500,"Census Tract 865, Queens County, New York",30714,4311,3441,79,2462,228,1849,545
36081086900,"Census Tract 869, Queens County, New York",30000,1771,1617,5,951,105,820,49
36081087100,"Census Tract 871, Queens County, New York",41484,2643,1402,545,1469,588,1174,195
36081088400,"Census Tract 884, Queens County, New York",90977,8345,96,101,4112,1536,4233,7252
36081088901,"Census Tract 889.01, Queens County, New York",48526,9626,6381,286,5308,1981,4318,1467
36081089200,"Census Tract 892, Queens County, New York",113269,7916,239,98,4114,682,3802,7332
36081090700,"Census Tract 907, Queens County, New York",51696,1434,582,0,716,393,718,501
36081091601,"Census Tract 916.01, Queens County, New York",105750,3674,24,23,2043,249,1631,3490
36081091602,"Census Tract 916.02, Queens County, New York",NA,0,0,0,0,0,0,0
36081091800,"Census Tract 918, Queens County, New York",NA,11,0,0,3,0,8,11
36081091900,"Census Tract 919, Queens County, New York",49650,5309,1927,285,2571,2019,2738,1279
36081092200,"Census Tract 922, Queens County, New York",131146,2020,43,0,1067,119,953,1970
36081092500,"Census Tract 925, Queens County, New York",47419,3470,1224,126,1637,1469,1833,988
36081092800,"Census Tract 928, Queens County, New York",159773,3594,52,0,1687,96,1907,3528
36081092900,"Census Tract 929, Queens County, New York",60973,7036,2177,94,3752,3312,3284,1941
36081093401,"Census Tract 934.01, Queens County, New York",86942,3734,80,85,1888,378,1846,3406
36081093402,"Census Tract 934.02, Queens County, New York",87463,4403,274,239,2261,489,2142,3473
36081093800,"Census Tract 938, Queens County, New York",52196,5023,171,463,2402,1048,2621,3919
36081093900,"Census Tract 939, Queens County, New York",81677,5299,1759,258,2826,1800,2473,1823
36081094201,"Census Tract 942.01, Queens County, New York",66435,3236,41,945,1374,1270,1862,1431
36081094202,"Census Tract 942.02, Queens County, New York",44013,4806,292,2047,2453,1651,2353,1776
36081094203,"Census Tract 942.03, Queens County, New York",57411,6602,154,921,3674,2029,2928,4567
36081094500,"Census Tract 945, Queens County, New York",75048,3654,913,18,1758,872,1896,1979
36081094700,"Census Tract 947, Queens County, New York",67625,2202,307,27,1041,1033,1161,1055
36081095400,"Census Tract 954, Queens County, New York",57984,6045,315,3931,3284,1190,2761,1191
36081096400,"Census Tract 964, Queens County, New York",77292,6573,591,3747,3258,1277,3315,1419
36081097202,"Census Tract 972.02, Queens County, New York",31509,3060,6,2376,1817,556,1243,359
36081097203,"Census Tract 972.03, Queens County, New York",30536,7356,457,4193,3891,2717,3465,1472
36081097204,"Census Tract 972.04, Queens County, New York",46051,3884,128,2315,2297,1070,1587,831
36081097300,"Census Tract 973, Queens County, New York",100750,1763,170,17,950,287,813,1454
36081098100,"Census Tract 981, Queens County, New York",89286,2236,524,0,1110,239,1126,1693
36081098700,"Census Tract 987, Queens County, New York",88077,2434,233,5,1286,197,1148,2136
36081099100,"Census Tract 991, Queens County, New York",100965,7204,1004,0,3887,751,3317,6000
36081099200,"Census Tract 992, Queens County, New York",38301,4339,79,2301,2217,1293,2122,1004
36081099701,"Census Tract 997.01, Queens County, New York",99342,2922,653,12,1733,285,1189,2189
36081099703,"Census Tract 997.03, Queens County, New York",83669,3746,1536,69,2214,282,1532,1825
36081099704,"Census Tract 997.04, Queens County, New York",75344,6847,1731,128,3962,867,2885,4572
36081099705,"Census Tract 997.05, Queens County, New York",109219,2470,1165,0,1184,245,1286,1198
36081099801,"Census Tract 998.01, Queens County, New York",75921,8592,247,5762,4785,2049,3807,988
36081099802,"Census Tract 998.02, Queens County, New York",43961,6422,221,4301,4024,813,2398,1613
36081099900,"Census Tract 999, Queens County, New York",NA,0,0,0,0,0,0,0
36081100801,"Census Tract 1008.01, Queens County, New York",92768,2525,112,1025,1239,374,1286,1135
36081100802,"Census Tract 1008.02, Queens County, New York",64267,8976,428,3941,4403,2094,4573,4085
36081101001,"Census Tract 1010.01, Queens County, New York",41332,12253,226,5599,6752,3545,5501,4605
36081101002,"Census Tract 1010.02, Queens County, New York",31066,4359,116,778,2026,459,2333,3442
36081101700,"Census Tract 1017, Queens County, New York",86493,6005,1700,80,3302,1319,2703,3730
36081102900,"Census Tract 1029, Queens County, New York",85141,3598,493,74,1873,607,1725,2590
36081103201,"Census Tract 1032.01, Queens County, New York",40595,6509,399,3336,3675,2672,2834,1713
36081103202,"Census Tract 1032.02, Queens County, New York",58750,8121,84,1253,3947,3182,4174,5575
36081103300,"Census Tract 1033, Queens County, New York",87566,4577,1448,44,2273,469,2304,2914
36081103900,"Census Tract 1039, Queens County, New York",77993,6283,2305,0,3411,1256,2872,3367
36081104700,"Census Tract 1047, Queens County, New York",55328,6755,3831,3,3294,589,3461,2353
36081105900,"Census Tract 1059, Queens County, New York",88906,3907,1442,2,2009,164,1898,2363
36081107201,"Census Tract 1072.01, Queens County, New York",86055,2320,116,39,1085,254,1235,2086
36081107202,"Census Tract 1072.02, Queens County, New York",NA,0,0,0,0,0,0,0
36081108500,"Census Tract 1085, Queens County, New York",77500,2337,929,32,1213,319,1124,1238
36081109300,"Census Tract 1093, Queens County, New York",89241,2937,1406,6,1473,301,1464,1483
36081109700,"Census Tract 1097, Queens County, New York",95701,1598,517,21,793,165,805,1004
36081109900,"Census Tract 1099, Queens County, New York",67031,3058,1619,24,1454,180,1604,1320
36081111300,"Census Tract 1113, Queens County, New York",102222,2526,889,13,1213,393,1313,1388
36081112300,"Census Tract 1123, Queens County, New York",95250,2058,727,94,1059,518,999,1042
36081112900,"Census Tract 1129, Queens County, New York",82173,2085,652,57,1158,151,927,1278
36081113300,"Census Tract 1133, Queens County, New York",103056,1603,389,0,795,362,808,1097
36081113900,"Census Tract 1139, Queens County, New York",65698,3356,1346,78,1750,576,1606,1482
36081114100,"Census Tract 1141, Queens County, New York",99583,2362,1075,33,1243,248,1119,1173
36081114700,"Census Tract 1147, Queens County, New York",89423,1726,735,0,838,123,888,863
36081115100,"Census Tract 1151, Queens County, New York",76167,915,256,0,472,153,443,506
36081115500,"Census Tract 1155, Queens County, New York",51442,2150,972,60,1096,722,1054,450
36081115700,"Census Tract 1157, Queens County, New York",45250,3207,2180,106,1551,305,1656,593
36081115900,"Census Tract 1159, Queens County, New York",59125,4256,3102,11,2202,378,2054,562
36081116100,"Census Tract 1161, Queens County, New York",26783,4301,3233,89,2449,453,1852,579
36081116300,"Census Tract 1163, Queens County, New York",36261,9346,5861,262,5266,2217,4080,1491
36081116700,"Census Tract 1167, Queens County, New York",40714,1676,1250,17,782,305,894,153
36081117100,"Census Tract 1171, Queens County, New York",58929,2359,1141,37,1130,583,1229,867
36081117500,"Census Tract 1175, Queens County, New York",62639,4830,2405,11,2476,678,2354,2173
36081118100,"Census Tract 1181, Queens County, New York",66711,1530,725,41,858,189,672,658
36081118500,"Census Tract 1185, Queens County, New York",45948,1978,1164,12,995,654,983,349
36081118700,"Census Tract 1187, Queens County, New York",45867,2484,1549,17,1269,606,1215,655
36081118900,"Census Tract 1189, Queens County, New York",61630,2050,1402,18,866,301,1184,509
36081119100,"Census Tract 1191, Queens County, New York",39605,2985,1684,0,1520,978,1465,690
36081119300,"Census Tract 1193, Queens County, New York",52000,1978,1361,39,1062,177,916,421
36081119500,"Census Tract 1195, Queens County, New York",84279,1453,504,3,750,352,703,584
36081119900,"Census Tract 1199, Queens County, New York",61522,1517,1067,3,687,175,830,264
36081120100,"Census Tract 1201, Queens County, New York",61806,1559,1129,80,824,153,735,226
36081120300,"Census Tract 1203, Queens County, New York",60179,1573,1224,17,664,132,909,269
36081120500,"Census Tract 1205, Queens County, New York",24826,2568,2090,153,1343,120,1225,237
36081120700,"Census Tract 1207, Queens County, New York",81250,3097,1687,38,1549,490,1548,1176
36081121100,"Census Tract 1211, Queens County, New York",NA,0,0,0,0,0,0,0
36081121500,"Census Tract 1215, Queens County, New York",79297,4447,2693,190,2309,744,2138,1235
36081122300,"Census Tract 1223, Queens County, New York",69317,3438,1745,11,1859,683,1579,1258
36081122701,"Census Tract 1227.01, Queens County, New York",67811,11356,3135,1570,6249,3370,5107,4494
36081122702,"Census Tract 1227.02, Queens County, New York",25473,7519,1055,2207,4338,3206,3181,2504
36081124100,"Census Tract 1241, Queens County, New York",72446,3666,1809,221,1939,344,1727,1278
36081124700,"Census Tract 1247, Queens County, New York",97500,3508,1861,12,1784,125,1724,1548
36081125700,"Census Tract 1257, Queens County, New York",61513,3248,1502,572,1755,623,1493,737
36081126500,"Census Tract 1265, Queens County, New York",71250,1743,766,39,879,164,864,636
36081126700,"Census Tract 1267, Queens County, New York",76250,4716,1138,817,2729,1072,1987,1871
36081127700,"Census Tract 1277, Queens County, New York",143281,3615,436,331,1864,78,1751,2847
36081128300,"Census Tract 1283, Queens County, New York",NA,0,0,0,0,0,0,0
36081129102,"Census Tract 1291.02, Queens County, New York",118824,3912,1036,142,1801,352,2111,2416
36081129103,"Census Tract 1291.03, Queens County, New York",61434,3887,1132,56,1855,396,2032,2557
36081129104,"Census Tract 1291.04, Queens County, New York",81875,4455,1666,81,2505,832,1950,2591
36081130100,"Census Tract 1301, Queens County, New York",87404,4204,807,744,2275,1218,1929,1899
36081133300,"Census Tract 1333, Queens County, New York",97663,3896,1668,69,1915,247,1981,1926
36081133900,"Census Tract 1339, Queens County, New York",117407,1302,336,1,758,199,544,912
36081134100,"Census Tract 1341, Queens County, New York",90000,3358,1695,28,1542,659,1816,1429
36081134700,"Census Tract 1347, Queens County, New York",68485,10944,5600,1098,5940,1584,5004,2602
36081136700,"Census Tract 1367, Queens County, New York",89116,5846,2748,342,3036,1019,2810,2254
36081137700,"Census Tract 1377, Queens County, New York",72719,7123,3812,704,3704,945,3419,1895
36081138501,"Census Tract 1385.01, Queens County, New York",102926,4617,2807,92,2180,170,2437,1646
36081138502,"Census Tract 1385.02, Queens County, New York",NA,39,0,0,0,24,39,39
36081139900,"Census Tract 1399, Queens County, New York",106583,1666,1030,2,859,76,807,600
36081140300,"Census Tract 1403, Queens County, New York",80457,2344,1437,9,1263,146,1081,856
36081140901,"Census Tract 1409.01, Queens County, New York",85000,990,597,36,467,136,523,333
36081140902,"Census Tract 1409.02, Queens County, New York",91042,2787,1912,3,1450,187,1337,763
36081141700,"Census Tract 1417, Queens County, New York",73182,4871,2792,43,2529,635,2342,1591
36081142900,"Census Tract 1429, Queens County, New York",84750,3760,1793,0,1833,292,1927,1687
36081143500,"Census Tract 1435, Queens County, New York",95472,2452,1433,3,1257,159,1195,822
36081144100,"Census Tract 1441, Queens County, New York",108614,2662,1270,94,1243,494,1419,1126
36081144700,"Census Tract 1447, Queens County, New York",84659,3109,1773,680,1650,259,1459,520
36081145101,"Census Tract 1451.01, Queens County, New York",71111,1127,512,0,583,33,544,585
36081145102,"Census Tract 1451.02, Queens County, New York",93000,2464,1578,135,1357,174,1107,694
36081145900,"Census Tract 1459, Queens County, New York",77868,2809,1177,9,1314,610,1495,1445
36081146300,"Census Tract 1463, Queens County, New York",71899,2979,1203,100,1588,432,1391,1407
36081146700,"Census Tract 1467, Queens County, New York",88412,2619,1079,0,1431,338,1188,1453
36081147100,"Census Tract 1471, Queens County, New York",85741,3231,1418,42,1523,195,1708,1578
36081147900,"Census Tract 1479, Queens County, New York",89286,4526,1582,130,2391,839,2135,2313
36081148300,"Census Tract 1483, Queens County, New York",115714,2900,872,8,1441,234,1459,1875
36081150701,"Census Tract 1507.01, Queens County, New York",146071,3036,984,12,1626,418,1410,1847
36081150702,"Census Tract 1507.02, Queens County, New York",101250,3067,950,34,1602,289,1465,1833
36081152901,"Census Tract 1529.01, Queens County, New York",93819,6916,3374,472,3762,793,3154,2844
36081152902,"Census Tract 1529.02, Queens County, New York",75702,4955,2274,103,2530,245,2425,2300
36081155101,"Census Tract 1551.01, Queens County, New York",55313,1759,42,0,1209,26,550,1717
36081155102,"Census Tract 1551.02, Queens County, New York",92739,8929,2783,765,4801,1284,4128,4727
36081156700,"Census Tract 1567, Queens County, New York",57750,1614,610,445,705,311,909,465
36081157101,"Census Tract 1571.01, Queens County, New York",97629,8406,4368,178,4353,1595,4053,2653
36081157102,"Census Tract 1571.02, Queens County, New York",97500,2294,1425,54,1119,337,1175,588
36081157901,"Census Tract 1579.01, Queens County, New York",102725,5073,2592,215,2704,546,2369,1689
36081157902,"Census Tract 1579.02, Queens County, New York",110000,4129,2242,81,2068,237,2061,1341
36081157903,"Census Tract 1579.03, Queens County, New York",82978,4741,2712,149,2524,290,2217,1666
36081161700,"Census Tract 1617, Queens County, New York",117813,4762,1419,645,2328,941,2434,2146
36081162100,"Census Tract 1621, Queens County, New York",76655,6363,2519,418,3150,1710,3213,2010
36085000300,"Census Tract 3, Richmond County, New York",86477,2004,356,172,909,480,1095,1287
36085000600,"Census Tract 6, Richmond County, New York",66563,2311,442,250,1193,328,1118,1487
36085000700,"Census Tract 7, Richmond County, New York",37952,4557,173,2337,2824,1351,1733,1735
36085000800,"Census Tract 8, Richmond County, New York",78986,5238,1165,437,2782,961,2456,3227
36085000900,"Census Tract 9, Richmond County, New York",50543,1510,132,532,762,539,748,656
36085001100,"Census Tract 11, Richmond County, New York",48082,3314,78,1624,1788,1343,1526,1061
36085001700,"Census Tract 17, Richmond County, New York",42431,1475,127,271,715,404,760,802
36085001800,"Census Tract 18, Richmond County, New York",80313,588,18,49,235,126,353,467
36085002001,"Census Tract 20.01, Richmond County, New York",80833,2502,279,288,1285,592,1217,1620
36085002002,"Census Tract 20.02, Richmond County, New York",100385,3473,473,210,1846,128,1627,2613
36085002100,"Census Tract 21, Richmond County, New York",50489,4469,326,1398,2175,1600,2294,2119
36085002700,"Census Tract 27, Richmond County, New York",NA,1751,106,508,905,580,846,823
36085002900,"Census Tract 29, Richmond County, New York",24779,4702,261,2315,2433,1953,2269,1345
36085003300,"Census Tract 33, Richmond County, New York",82483,3751,350,1195,1714,589,2037,1856
36085003600,"Census Tract 36, Richmond County, New York",88097,2833,592,448,1413,443,1420,1570
36085003900,"Census Tract 39, Richmond County, New York",70586,2376,136,544,1267,446,1109,1554
36085004000,"Census Tract 40, Richmond County, New York",33984,12548,1875,6365,6221,3989,6327,3168
36085004700,"Census Tract 47, Richmond County, New York",88571,2805,289,209,1486,244,1319,2239
36085005000,"Census Tract 50, Richmond County, New York",81875,4004,687,175,2084,726,1920,2742
36085005900,"Census Tract 59, Richmond County, New York",81583,3067,217,163,1692,475,1375,2501
36085006400,"Census Tract 64, Richmond County, New York",49449,3450,329,647,2034,556,1416,2213
36085006700,"Census Tract 67, Richmond County, New York",121176,2468,122,72,1214,158,1254,2158
36085007000,"Census Tract 70, Richmond County, New York",76149,9480,1103,499,4726,1961,4754,7396
36085007400,"Census Tract 74, Richmond County, New York",81033,4902,951,245,2569,661,2333,3343
36085007500,"Census Tract 75, Richmond County, New York",65833,4299,114,808,1982,1320,2317,2738
36085007700,"Census Tract 77, Richmond County, New York",57000,1526,85,598,746,703,780,762
36085008100,"Census Tract 81, Richmond County, New York",37287,4313,294,1331,2125,1155,2188,2032
36085009601,"Census Tract 96.01, Richmond County, New York",91563,4489,366,63,2361,524,2128,3749
36085009602,"Census Tract 96.02, Richmond County, New York",85750,3149,393,81,1567,350,1582,2530
36085009700,"Census Tract 97, Richmond County, New York",75648,4535,106,1652,2285,1057,2250,2253
36085010500,"Census Tract 105, Richmond County, New York",69583,4372,398,672,2375,1498,1997,2363
36085011201,"Census Tract 112.01, Richmond County, New York",79557,6358,556,60,3290,1111,3068,5601
36085011202,"Census Tract 112.02, Richmond County, New York",81016,5731,571,639,2977,1419,2754,3897
36085011401,"Census Tract 114.01, Richmond County, New York",44357,2971,301,608,1526,705,1445,1651
36085011402,"Census Tract 114.02, Richmond County, New York",83750,3398,298,59,1785,564,1613,3025
36085012100,"Census Tract 121, Richmond County, New York",108906,3143,29,31,1626,659,1517,2641
36085012200,"Census Tract 122, Richmond County, New York",81613,3938,311,1,2067,418,1871,3541
36085012500,"Census Tract 125, Richmond County, New York",81250,3047,165,468,1569,1109,1478,2202
36085012804,"Census Tract 128.04, Richmond County, New York",81107,4042,420,49,2127,518,1915,3395
36085012805,"Census Tract 128.05, Richmond County, New York",80379,2605,143,22,1346,366,1259,2440
36085012806,"Census Tract 128.06, Richmond County, New York",57212,5445,552,379,3039,783,2406,3832
36085013201,"Census Tract 132.01, Richmond County, New York",102500,1480,146,20,739,143,741,1249
36085013203,"Census Tract 132.03, Richmond County, New York",87014,5729,155,297,2872,601,2857,5136
36085013204,"Census Tract 132.04, Richmond County, New York",87561,4863,143,2,2567,687,2296,4571
36085013301,"Census Tract 133.01, Richmond County, New York",9899,1095,41,668,720,455,375,292
36085013302,"Census Tract 133.02, Richmond County, New York",47905,3096,131,1238,1716,1528,1380,1333
36085013400,"Census Tract 134, Richmond County, New York",85399,4099,151,21,2115,640,1984,3552
36085013800,"Census Tract 138, Richmond County, New York",87418,6092,325,0,3199,995,2893,5542
36085014100,"Census Tract 141, Richmond County, New York",74773,2287,331,380,1234,780,1053,1223
36085014604,"Census Tract 146.04, Richmond County, New York",103964,6866,573,16,3776,531,3090,5862
36085014605,"Census Tract 146.05, Richmond County, New York",112143,3853,274,10,2043,114,1810,3568
36085014606,"Census Tract 146.06, Richmond County, New York",103825,5963,146,23,3074,521,2889,5683
36085014607,"Census Tract 146.07, Richmond County, New York",95114,4601,457,58,2407,242,2194,3986
36085014608,"Census Tract 146.08, Richmond County, New York",110469,3477,91,23,1813,485,1664,3308
36085014700,"Census Tract 147, Richmond County, New York",99856,3124,35,210,1690,290,1434,2740
36085015100,"Census Tract 151, Richmond County, New York",98438,5374,367,55,2644,947,2730,4731
36085015400,"Census Tract 154, Richmond County, New York",NA,0,0,0,0,0,0,0
36085015601,"Census Tract 156.01, Richmond County, New York",105344,6391,265,4,3429,479,2962,6121
36085015602,"Census Tract 156.02, Richmond County, New York",112283,3242,41,27,1665,197,1577,3161
36085015603,"Census Tract 156.03, Richmond County, New York",90106,4844,157,0,2591,784,2253,4618
36085016901,"Census Tract 169.01, Richmond County, New York",98750,3808,387,130,1688,487,2120,3224
36085017005,"Census Tract 170.05, Richmond County, New York",100673,5114,637,31,2741,337,2373,4422
36085017007,"Census Tract 170.07, Richmond County, New York",79934,5547,644,194,2705,1197,2842,4559
36085017008,"Census Tract 170.08, Richmond County, New York",109412,7795,255,0,4028,524,3767,7483
36085017009,"Census Tract 170.09, Richmond County, New York",93125,4485,188,0,2098,302,2387,4198
36085017010,"Census Tract 170.10, Richmond County, New York",82723,9060,473,120,5203,1985,3857,8258
36085017011,"Census Tract 170.11, Richmond County, New York",100662,4865,69,2,2671,645,2194,4732
36085017012,"Census Tract 170.12, Richmond County, New York",89273,4321,235,48,2297,610,2024,3882
36085017300,"Census Tract 173, Richmond County, New York",36707,2343,582,472,1363,503,980,1060
36085017600,"Census Tract 176, Richmond County, New York",125139,4849,49,73,2406,171,2443,4683
36085017700,"Census Tract 177, Richmond County, New York",115603,5983,759,6,3262,240,2721,5120
36085018100,"Census Tract 181, Richmond County, New York",127074,3055,303,44,1631,133,1424,2678
36085018701,"Census Tract 187.01, Richmond County, New York",104118,1874,205,42,947,392,927,1395
36085018702,"Census Tract 187.02, Richmond County, New York",112742,7947,1817,355,4690,827,3257,5465
36085018901,"Census Tract 189.01, Richmond County, New York",76518,5057,928,151,2480,796,2577,3801
36085018902,"Census Tract 189.02, Richmond County, New York",102525,5504,1363,88,2774,665,2730,3644
36085019700,"Census Tract 197, Richmond County, New York",103000,1755,113,5,873,83,882,1580
36085019800,"Census Tract 198, Richmond County, New York",124130,7410,259,100,3632,867,3778,6871
36085020100,"Census Tract 201, Richmond County, New York",99141,3524,394,377,1763,1034,1761,2567
36085020700,"Census Tract 207, Richmond County, New York",33670,5499,86,2117,2539,2868,2960,2863
36085020801,"Census Tract 208.01, Richmond County, New York",100543,8498,390,15,4174,831,4324,8023
36085020803,"Census Tract 208.03, Richmond County, New York",119750,7381,275,0,3506,519,3875,6878
36085020804,"Census Tract 208.04, Richmond County, New York",102857,5991,242,2,2901,261,3090,5369
36085021300,"Census Tract 213, Richmond County, New York",69640,4681,283,776,2271,2138,2410,3062
36085022300,"Census Tract 223, Richmond County, New York",63750,2745,89,1078,1464,1150,1281,1367
36085022600,"Census Tract 226, Richmond County, New York",122917,8141,149,122,4396,908,3745,7743
36085022800,"Census Tract 228, Richmond County, New York",NA,23,0,5,0,0,23,18
36085023100,"Census Tract 231, Richmond County, New York",82599,5276,738,1842,2557,1859,2719,2452
36085023900,"Census Tract 239, Richmond County, New York",83883,3853,117,720,1899,1964,1954,2395
36085024401,"Census Tract 244.01, Richmond County, New York",76394,6228,240,0,3379,667,2849,5606
36085024402,"Census Tract 244.02, Richmond County, New York",88906,4426,167,41,2195,233,2231,4134
36085024700,"Census Tract 247, Richmond County, New York",64297,2994,433,685,1537,1074,1457,1413
36085024800,"Census Tract 248, Richmond County, New York",92237,5039,271,22,2535,631,2504,4585
36085025100,"Census Tract 251, Richmond County, New York",107239,6119,966,170,3036,756,3083,4605
36085027301,"Census Tract 273.01, Richmond County, New York",68542,3782,1151,33,1970,344,1812,2342
36085027302,"Census Tract 273.02, Richmond County, New York",85050,4060,793,7,2123,233,1937,3230
36085027702,"Census Tract 277.02, Richmond County, New York",75022,6893,1148,110,3433,1339,3460,5473
36085027704,"Census Tract 277.04, Richmond County, New York",105341,4629,724,9,2446,491,2183,3631
36085027705,"Census Tract 277.05, Richmond County, New York",86397,5809,1489,190,2928,495,2881,3866
36085027706,"Census Tract 277.06, Richmond County, New York",103897,3489,625,250,1695,474,1794,2358
36085027900,"Census Tract 279, Richmond County, New York",115682,2219,243,31,1177,179,1042,1907
36085029102,"Census Tract 291.02, Richmond County, New York",83750,3006,617,52,1389,756,1617,2120
36085029103,"Census Tract 291.03, Richmond County, New York",104146,8266,936,179,4126,1428,4140,6276
36085029104,"Census Tract 291.04, Richmond County, New York",94292,7229,803,523,3933,1518,3296,5294
36085030301,"Census Tract 303.01, Richmond County, New York",85826,4972,901,477,2420,1564,2552,3154
36085030302,"Census Tract 303.02, Richmond County, New York",85660,6702,811,1065,3222,2684,3480,3592
36085031901,"Census Tract 319.01, Richmond County, New York",21250,2816,207,1284,1522,936,1294,1090
36085031902,"Census Tract 319.02, Richmond County, New York",46118,5343,158,2969,2929,1714,2414,1756
36085032300,"Census Tract 323, Richmond County, New York",65089,1073,16,420,520,453,553,500
36085990100,"Census Tract 9901, Richmond County, New York",NA,0,0,0,0,0,0,0
